DEPP;CODCOMP;COMP;DEP;CODCOM;COM;PMUN;PCAP;PTOT
01;015;Arboys en Bugey;01;015;Arbignieu;522;12;534
01;025;Bâgé-Dommartin;01;025;Bâgé-la-Ville;3180;74;3254
01;033;Valserhône;01;033;Bellegarde-sur-Valserine;11385;233;11618
01;036;Valromey-sur-Séran;01;036;Belmont-Luthézieu;605;12;617
01;453;Arvière-en-Valromey;01;059;Brénaz;101;2;103
01;080;Champdor-Corcelles;01;080;Champdor;437;8;445
01;033;Valserhône;01;091;Châtillon-en-Michaille;3972;81;4053
01;095;Nivigne et Suran;01;095;Chavannes-sur-Suran;709;15;724
01;453;Arvière-en-Valromey;01;097;Chavornay;200;4;204
01;080;Champdor-Corcelles;01;119;Corcelles;199;8;207
01;262;Montluel;01;120;Cordieux;534;8;542
01;185;Plateau d'Hauteville;01;122;Cormaranche-en-Bugey;789;56;845
01;130;Bresse Vallons;01;130;Cras-sur-Reyssouze;1503;18;1521
01;426;Val-Revermont;01;137;Cuisiat;581;13;594
01;025;Bâgé-Dommartin;01;144;Dommartin;888;30;918
01;130;Bresse Vallons;01;154;Étrez;865;20;885
01;095;Nivigne et Suran;01;172;Germagnat;134;3;137
01;338;Groslée-Saint-Benoit;01;182;Groslée;376;8;384
01;185;Plateau d'Hauteville;01;185;Hauteville-Lompnes;3637;93;3730
01;185;Plateau d'Hauteville;01;186;Hostiaz;92;2;94
01;204;Le Poizat-Lalleyriat;01;204;Lalleyriat;257;8;265
01;033;Valserhône;01;205;Lancrans;1077;22;1099
01;215;Surjoux-Lhopital;01;215;Lhôpital;53;0;53
01;453;Arvière-en-Valromey;01;218;Lochieu;82;2;84
01;036;Valromey-sur-Séran;01;221;Lompnieu;132;1;133
01;286;Parves et Nattages;01;271;Nattages;597;24;621
01;286;Parves et Nattages;01;286;Parves;362;13;375
01;204;Le Poizat-Lalleyriat;01;300;Le Poizat;489;8;497
01;426;Val-Revermont;01;312;Pressiat;257;2;259
01;245;Bohas-Meyriat-Rignat;01;324;Rignat;264;2;266
01;338;Groslée-Saint-Benoit;01;338;Saint-Benoît;869;26;895
01;015;Arboys en Bugey;01;340;Saint-Bois;141;3;144
01;215;Surjoux-Lhopital;01;413;Surjoux;90;2;92
01;036;Valromey-sur-Séran;01;414;Sutrieu;218;4;222
01;185;Plateau d'Hauteville;01;417;Thézillieu;306;6;312
01;426;Val-Revermont;01;426;Treffort;1668;40;1708
01;036;Valromey-sur-Séran;01;442;Vieu;379;7;386
01;453;Arvière-en-Valromey;01;453;Virieu-le-Petit;329;9;338
02;018;Anizy-le-Grand;02;018;Anizy-le-Château;1957;40;1997
02;458;Dhuys et Morin-en-Brie;02;026;Artonges;170;2;172
02;053;Vallées en Champagne;02;053;Baulne-en-Brie;266;2;268
02;054;Bazoches-et-Saint-Thibaut;02;054;Bazoches-sur-Vesles;449;15;464
02;458;Dhuys et Morin-en-Brie;02;147;La Celle-sous-Montmirail;103;3;106
02;153;Cessières-Suzy;02;153;Cessières;468;11;479
02;053;Vallées en Champagne;02;161;La Chapelle-Monthodon;203;4;207
59;545;Saint-Souplet;02;285;Escaufourt;171;5;176
02;738;Tergnier;02;300;Fargniers;3373;47;3420
02;018;Anizy-le-Grand;02;301;Faucoucourt;333;7;340
02;458;Dhuys et Morin-en-Brie;02;325;Fontenelle-en-Brie;215;4;219
02;439;Les Septvallons;02;348;Glennes;224;4;228
02;360;Villeneuve-sur-Aisne;02;360;Guignicourt;2251;28;2279
02;018;Anizy-le-Grand;02;434;Lizy;297;7;304
02;439;Les Septvallons;02;439;Longueval-Barbonval;484;5;489
02;458;Dhuys et Morin-en-Brie;02;458;Marchais-en-Brie;334;5;339
02;360;Villeneuve-sur-Aisne;02;475;Menneville;529;7;536
02;439;Les Septvallons;02;479;Merval;119;1;120
02;439;Les Septvallons;02;597;Perles;96;1;97
02;738;Tergnier;02;630;Quessy;2966;42;3008
02;439;Les Septvallons;02;646;Révillon;65;1;66
02;053;Vallées en Champagne;02;669;Saint-Agnan;104;0;104
02;054;Bazoches-et-Saint-Thibaut;02;695;Saint-Thibaut;83;0;83
02;153;Cessières-Suzy;02;733;Suzy;307;10;317
02;439;Les Septvallons;02;771;Vauxcéré;86;0;86
02;439;Les Septvallons;02;811;Villers-en-Prayères;122;1;123
02;738;Tergnier;02;825;Vouël;2194;31;2225
03;158;Haut-Bocage;03;123;Givarlais;202;2;204
03;158;Haut-Bocage;03;153;Louroux-Hodement;369;5;374
03;158;Haut-Bocage;03;158;Maillet;289;8;297
03;168;Meaulne-Vitray;03;168;Meaulne;773;12;785
03;168;Meaulne-Vitray;03;318;Vitray;135;1;136
04;081;Esparron-de-Verdon;04;003;Albiosc;37;0;37
04;136;La Mure-Argens;04;010;Argens;12;0;12
04;023;Bayons;04;011;Astoin;7;0;7
04;155;Prads-Haute-Bléone;04;029;Blégiers;68;0;68
04;033;Ubaye-Serre-Ponçon;04;033;La Bréole;392;11;403
04;144;La Palud-sur-Verdon;04;052;Châteauneuf-lès-Moustiers;56;0;56
04;023;Bayons;04;082;Esparron-la-Bâtie;12;0;12
04;120;Val d'Oronaye;04;100;Larche;56;0;56
04;192;Saint-Michel-l'Observatoire;04;105;Lincel;219;5;224
04;120;Val d'Oronaye;04;120;Meyronnes;61;1;62
04;124;Montagnac-Montpezat;04;131;Montpezat;34;0;34
04;204;Senez;04;153;Le Poil;5;0;5
04;023;Bayons;04;165;Reynier;13;0;13
04;033;Ubaye-Serre-Ponçon;04;198;Saint-Vincent-les-Forts;390;7;397
05;001;Abriès-Ristolas;05;001;Abriès;289;6;295
05;118;Val Buëch-Méouge;05;005;Antonaves;142;2;144
05;132;Saint-Bonnet-en-Champsaur;05;020;Bénévent-et-Charbillac;291;10;301
05;024;Valdoule;05;024;Bruis;78;3;81
05;118;Val Buëch-Méouge;05;034;Châteauneuf-de-Chabre;370;7;377
05;132;Saint-Bonnet-en-Champsaur;05;067;Les Infournas;29;0;29
05;024;Valdoule;05;088;Montmorin;104;5;109
05;118;Val Buëch-Méouge;05;118;Ribiers;817;18;835
05;001;Abriès-Ristolas;05;120;Ristolas;94;0;94
05;061;Gap;05;125;Romette;1639;58;1697
05;132;Saint-Bonnet-en-Champsaur;05;132;Saint-Bonnet-en-Champsaur;1758;58;1816
05;024;Valdoule;05;150;Sainte-Marie;36;0;36
07;011;Vallées-d'Antraigues-Asperjoc;07;011;Antraigues-sur-Volane;502;8;510
07;011;Vallées-d'Antraigues-Asperjoc;07;016;Asperjoc;365;10;375
07;334;Les Vans;07;043;Brahic;89;2;91
07;031;Berrias-et-Casteljau;07;046;Casteljau;307;11;318
07;334;Les Vans;07;057;Chassagnes;188;3;191
07;262;Saint-Laurent-les-Bains-Laval-d'Aurelle;07;135;Laval-d'Aurelle;27;0;27
07;334;Les Vans;07;164;Naves;553;20;573
07;165;Belsentes;07;165;Nonières;216;8;224
07;284;Saint-Pierre-Saint-Jean;07;246;Saint-Jean-de-Pourcharesse;80;1;81
07;165;Belsentes;07;256;Saint-Julien-Labrousse;337;14;351
07;262;Saint-Laurent-les-Bains-Laval-d'Aurelle;07;262;Saint-Laurent-les-Bains;149;3;152
08;116;Bairon et ses environs;08;007;Les Alleux;77;2;79
08;311;Mouzon;08;009;Amblimont;212;1;213
08;437;Tailly;08;012;Andevanne;21;0;21
08;173;Flize;08;042;Balaives-et-Butz;203;7;210
08;437;Tailly;08;050;Barricourt;50;4;54
08;069;Blanchefosse-et-Bay;08;051;Bay;54;0;54
08;053;Bazeilles;08;053;Bazeilles;1916;168;2084
08;490;Vouziers;08;068;Blaise;145;1;146
08;491;Vrigne aux Bois;08;072;Bosseval-et-Briancourt;394;7;401
08;173;Flize;08;079;Boutancourt;280;14;294
08;057;Belleville-et-Châtillon-sur-Bar;08;112;Châtillon-sur-Bar;113;2;115
08;115;Chémery-Chéhéry;08;114;Chéhéry;113;0;113
08;115;Chémery-Chéhéry;08;115;Chémery-sur-Bar;415;4;419
08;116;Bairon et ses environs;08;116;Le Chesne;884;15;899
08;145;Douzy;08;145;Douzy;1927;33;1960
08;173;Flize;08;152;Élan;87;2;89
08;173;Flize;08;173;Flize;1138;24;1162
08;189;Girondelle;08;177;Foulzy;66;0;66
08;198;Grandpré;08;198;Grandpré;392;12;404
08;366;Rocquigny;08;213;La Hardoye;72;1;73
08;113;Chaumont-Porcien;08;258;Logny-lès-Chaumont;26;0;26
08;116;Bairon et ses environs;08;261;Louvergny;65;1;66
08;366;Rocquigny;08;265;Mainbresson;95;0;95
08;366;Rocquigny;08;266;Mainbressy;121;1;122
08;145;Douzy;08;267;Mairy;255;6;261
08;328;Nouzonville;08;285;Meillier-Fontaine;46;1;47
08;311;Mouzon;08;311;Mouzon;2015;38;2053
08;362;Rethel;08;337;Pargny-Resson;226;2;228
08;333;Olizy-Primat;08;345;Primat;35;3;38
08;437;Tailly;08;359;Rémonville;59;1;60
08;053;Bazeilles;08;371;Rubécourt-et-Lamécourt;140;4;144
08;198;Grandpré;08;441;Termes;122;5;127
08;490;Vouziers;08;443;Terron-sur-Aisne;143;1;144
08;053;Bazeilles;08;475;Villers-Cernay;349;10;359
08;490;Vouziers;08;490;Vouziers;3548;124;3672
08;491;Vrigne aux Bois;08;491;Vrigne-aux-Bois;3162;45;3207
08;490;Vouziers;08;493;Vrizy;333;10;343
08;113;Chaumont-Porcien;08;495;Wadimont;52;1;53
09;296;Aulos-Sinsat;09;028;Aulos;53;2;55
09;306;Tarascon-sur-Ariège;09;036;Banat;121;3;124
09;062;Bordes-Uchentein;09;062;Les Bordes-sur-Lez;193;6;199
09;334;Val-de-Sos;09;135;Goulier;48;0;48
09;334;Val-de-Sos;09;286;Sem;22;0;22
09;296;Aulos-Sinsat;09;296;Sinsat;97;0;97
09;334;Val-de-Sos;09;302;Suc-et-Sentenac;54;0;54
09;062;Bordes-Uchentein;09;317;Uchentein;19;0;19
09;334;Val-de-Sos;09;334;Vicdessos;430;63;493
10;003;Aix-Villemaur-Pâlis;10;003;Aix-en-Othe;2411;24;2435
10;058;Bragelogne-Beauvoir;10;036;Beauvoir-sur-Sarce;60;0;60
10;003;Aix-Villemaur-Pâlis;10;277;Palis;643;10;653
10;148;Ferreux-Quincey;10;311;Quincey;93;1;94
10;003;Aix-Villemaur-Pâlis;10;415;Villemaur-sur-Vanne;483;5;488
11;304;Quillan;11;050;Brenac;226;1;227
11;323;Roquetaillade-et-Conilhac;11;097;Conilhac-de-la-Montagne;68;0;68
11;131;Val-du-Faby;11;131;Fa;356;8;364
11;080;Val de Lambronne;11;171;Gueytes-et-Labastide;31;1;32
11;251;Val-de-Dagne;11;251;Montlaur;543;10;553
11;251;Val-de-Dagne;11;298;Pradelles-en-Val;194;4;198
11;323;Roquetaillade-et-Conilhac;11;323;Roquetaillade;205;3;208
11;131;Val-du-Faby;11;329;Rouvenac;226;5;231
11;128;Escueillens-et-Saint-Just-de-Bélengard;11;349;Saint-Just-de-Bélengard;60;1;61
12;224;Saint Geniez d'Olt et d'Aubrac;12;014;Aurelle-Verlac;161;1;162
12;021;Le Bas Ségala;12;021;La Bastide-l'Évêque;748;17;765
12;270;Sévérac d'Aveyron;12;040;Buzeins;186;13;199
12;076;Conques-en-Rouergue;12;076;Conques;240;9;249
12;177;Palmas d'Aveyron;12;081;Coussergues;256;5;261
12;177;Palmas d'Aveyron;12;087;Cruéjouls;406;3;409
12;076;Conques-en-Rouergue;12;114;Grand-Vabre;367;14;381
12;120;Laissac-Sévérac l'Église;12;120;Laissac;1733;32;1765
12;270;Sévérac d'Aveyron;12;123;Lapanouse;755;47;802
12;270;Sévérac d'Aveyron;12;126;Lavernhe;220;7;227
12;257;Causse-et-Diège;12;132;Loupiac;415;10;425
12;076;Conques-en-Rouergue;12;173;Noailhac;149;5;154
12;177;Palmas d'Aveyron;12;177;Palmas;366;7;373
12;270;Sévérac d'Aveyron;12;196;Recoules-Prévinquières;483;4;487
12;076;Conques-en-Rouergue;12;218;Saint-Cyprien-sur-Dourdou;830;26;856
12;224;Saint Geniez d'Olt et d'Aubrac;12;224;Saint-Geniez-d'Olt;2056;38;2094
12;021;Le Bas Ségala;12;245;Saint-Salvadou;385;6;391
12;270;Sévérac d'Aveyron;12;270;Sévérac-le-Château;2435;48;2483
12;120;Laissac-Sévérac l'Église;12;271;Sévérac-l'Église;420;71;491
12;021;Le Bas Ségala;12;285;Vabre-Tizac;443;7;450
14;150;Cesny-les-Sources;14;002;Acqueville;212;1;213
14;281;Formigny La Bataille;14;004;Aignerville;206;1;207
14;005;Valambray;14;005;Airan;652;12;664
14;011;Aurseulles;14;011;Anctoville;433;5;438
14;150;Cesny-les-Sources;14;013;Angoville;22;1;23
14;027;Les Monts d'Aunay;14;027;Aunay-sur-Odon;3192;35;3227
14;371;Livarot-Pays-d'Auge;14;028;Auquainville;291;6;297
14;371;Livarot-Pays-d'Auge;14;029;Les Autels-Saint-Bazile;49;0;49
14;431;Mézidon Vallée d'Auge;14;031;Les Authieux-Papion;62;1;63
14;035;Balleroy-sur-Drôme;14;035;Balleroy;925;71;996
14;231;Beaufour-Druval;14;051;Beaufour;161;6;167
14;061;Souleuvre en Bocage;14;052;Beaulieu;196;4;200
14;027;Les Monts d'Aunay;14;056;Bauquay;289;6;295
14;371;Livarot-Pays-d'Auge;14;058;Bellou;133;1;134
14;061;Souleuvre en Bocage;14;061;Le Bény-Bocage;997;25;1022
14;726;Valdallière;14;065;Bernières-le-Patry;527;6;533
14;579;Seulline;14;073;La Bigne;213;3;216
14;005;Valambray;14;074;Billy;400;10;410
14;654;Saint-Pierre-en-Auge;14;081;Boissey;203;2;205
14;098;Thue et Mue;14;098;Bretteville-l'Orgueilleuse;3024;33;3057
14;654;Saint-Pierre-en-Auge;14;099;Bretteville-sur-Dives;269;5;274
14;576;Val-de-Vie;14;105;La Brévière;114;2;116
14;098;Thue et Mue;14;109;Brouay;464;5;469
14;266;Feuguerolles-Bully;14;112;Bully;244;5;249
14;726;Valdallière;14;113;Burcy;395;5;400
14;712;Troarn;14;114;Bures-sur-Dives;388;8;396
14;061;Souleuvre en Bocage;14;115;Bures-les-Monts;142;1;143
14;027;Les Monts d'Aunay;14;128;Campandré-Valcongrain;89;4;93
14;061;Souleuvre en Bocage;14;129;Campeaux;646;7;653
14;061;Souleuvre en Bocage;14;139;Carville;337;5;342
14;342;Isigny-sur-Mer;14;142;Castilly;290;4;294
14;143;Caumont-sur-Aure;14;143;Caumont-l'Éventé;1342;17;1359
14;689;Thury-Harcourt-le-Hom;14;144;Caumont-sur-Orne;74;1;75
14;371;Livarot-Pays-d'Auge;14;148;Cerqueux;82;4;86
14;150;Cesny-les-Sources;14;150;Cesny-Bois-Halbout;612;7;619
14;658;Noues de Sienne;14;151;Champ-du-Boult;371;4;375
14;174;Condé-en-Normandie;14;152;La Chapelle-Engerbold;92;1;93
14;576;Val-de-Vie;14;153;La Chapelle-Haute-Grue;73;1;74
14;570;Valorbiquet;14;154;La Chapelle-Yvon;551;4;555
14;371;Livarot-Pays-d'Auge;14;155;Cheffreville-Tonnencourt;290;6;296
14;726;Valdallière;14;156;Chênedollé;223;2;225
14;098;Thue et Mue;14;157;Cheux;1524;15;1539
14;456;Moult-Chicheboville;14;158;Chicheboville;573;10;583
14;349;Laize-Clinchamps;14;164;Clinchamps-sur-Orne;1324;18;1342
14;174;Condé-en-Normandie;14;174;Condé-sur-Noireau;4383;273;4656
14;005;Valambray;14;176;Conteville;90;2;92
14;762;Vire Normandie;14;187;Coulonces;762;38;800
14;579;Seulline;14;188;Coulvain;391;3;394
14;431;Mézidon Vallée d'Auge;14;189;Coupesarte;42;2;44
14;658;Noues de Sienne;14;192;Courson;391;4;395
14;431;Mézidon Vallée d'Auge;14;201;Crèvecœur-en-Auge;476;5;481
14;431;Mézidon Vallée d'Auge;14;208;Croissanville;532;4;536
14;371;Livarot-Pays-d'Auge;14;210;La Croupte;115;2;117
14;689;Thury-Harcourt-le-Hom;14;213;Curcy-sur-Orne;464;9;473
14;672;Val de Drôme;14;217;Dampierre;152;0;152
14;027;Les Monts d'Aunay;14;219;Danvou-la-Ferrière;158;6;164
14;726;Valdallière;14;222;Le Désert;73;0;73
14;281;Formigny La Bataille;14;235;Écrammeville;204;1;205
14;735;Vendeuvre;14;247;Escures-sur-Favières;357;4;361
14;726;Valdallière;14;253;Estry;344;6;350
14;061;Souleuvre en Bocage;14;255;Étouvy;254;11;265
14;371;Livarot-Pays-d'Auge;14;259;Familly;115;5;120
14;061;Souleuvre en Bocage;14;264;La Ferrière-Harang;322;3;325
14;371;Livarot-Pays-d'Auge;14;265;Fervaques;712;14;726
14;011;Aurseulles;14;267;Feuguerolles-sur-Seulles;168;1;169
14;005;Valambray;14;268;Fierville-Bray;470;13;483
14;658;Noues de Sienne;14;279;Fontenermont;147;2;149
14;281;Formigny La Bataille;14;281;Formigny;261;7;268
14;554;Le Castelet;14;294;Garcelles-Secqueville;1046;14;1060
14;658;Noues de Sienne;14;296;Le Gast;167;5;172
14;431;Mézidon Vallée d'Auge;14;313;Grandchamp-le-Château;83;0;83
14;061;Souleuvre en Bocage;14;317;La Graverie;1201;24;1225
14;735;Vendeuvre;14;321;Grisy;112;0;112
14;689;Thury-Harcourt-le-Hom;14;324;Hamars;457;2;459
14;371;Livarot-Pays-d'Auge;14;330;Heurtevent;187;2;189
14;654;Saint-Pierre-en-Auge;14;331;Hiéville;316;7;323
14;538;Castine-en-Plaine;14;339;Hubert-Folie;404;7;411
14;515;Port-en-Bessin-Huppain;14;340;Huppain;416;8;424
14;342;Isigny-sur-Mer;14;342;Isigny-sur-Mer;2492;25;2517
14;347;Dialan sur Chaîne;14;347;Jurques;674;8;682
14;349;Laize-Clinchamps;14;349;Laize-la-Ville;806;13;819
14;672;Val de Drôme;14;350;La Lande-sur-Drôme;68;1;69
14;543;Rots;14;356;Lasson;645;15;660
14;357;Terres de Druance;14;357;Lassy;313;9;322
14;431;Mézidon Vallée d'Auge;14;359;Lécaude;130;2;132
14;174;Condé-en-Normandie;14;361;Lénault;178;3;181
14;371;Livarot-Pays-d'Auge;14;371;Livarot;2012;28;2040
14;143;Caumont-sur-Aure;14;372;Livry;744;6;750
14;475;Val d'Arry;14;373;Le Locheur;250;4;254
14;011;Aurseulles;14;376;Longraye;193;2;195
14;281;Formigny La Bataille;14;382;Louvières;73;1;74
14;431;Mézidon Vallée d'Auge;14;386;Magny-la-Campagne;582;6;588
14;431;Mézidon Vallée d'Auge;14;387;Magny-le-Freule;336;4;340
14;762;Vire Normandie;14;388;Maisoncelles-la-Jourdan;468;23;491
14;061;Souleuvre en Bocage;14;395;Malloué;21;0;21
14;347;Dialan sur Chaîne;14;413;Le Mesnil-Auzouf;353;4;357
14;371;Livarot-Pays-d'Auge;14;414;Le Mesnil-Bacley;193;10;203
14;658;Noues de Sienne;14;415;Le Mesnil-Benoist;50;1;51
14;658;Noues de Sienne;14;416;Le Mesnil-Caussois;115;4;119
14;658;Noues de Sienne;14;417;Mesnil-Clinchamps;935;20;955
14;371;Livarot-Pays-d'Auge;14;418;Le Mesnil-Durand;296;5;301
14;371;Livarot-Pays-d'Auge;14;420;Le Mesnil-Germain;259;4;263
14;431;Mézidon Vallée d'Auge;14;422;Le Mesnil-Mauger;994;21;1015
14;098;Thue et Mue;14;423;Le Mesnil-Patry;394;5;399
14;371;Livarot-Pays-d'Auge;14;429;Meulles;353;4;357
14;431;Mézidon Vallée d'Auge;14;431;Mézidon-Canon;4800;46;4846
14;475;Val d'Arry;14;432;Missy;539;9;548
14;654;Saint-Pierre-en-Auge;14;433;Mittois;130;7;137
14;061;Souleuvre en Bocage;14;440;Montamy;93;2;95
14;061;Souleuvre en Bocage;14;441;Mont-Bertrand;235;5;240
14;726;Valdallière;14;442;Montchamp;534;9;543
14;061;Souleuvre en Bocage;14;443;Montchauvet;388;5;393
14;431;Mézidon Vallée d'Auge;14;444;Monteille;151;3;154
14;654;Saint-Pierre-en-Auge;14;450;Montviette;202;1;203
14;456;Moult-Chicheboville;14;456;Moult;2771;36;2807
14;371;Livarot-Pays-d'Auge;14;459;Les Moutiers-Hubert;39;0;39
14;342;Isigny-sur-Mer;14;462;Neuilly-la-Forêt;439;5;444
14;371;Livarot-Pays-d'Auge;14;471;Notre-Dame-de-Courson;364;6;370
14;654;Saint-Pierre-en-Auge;14;472;L'Oudon;1520;266;1786
14;475;Val d'Arry;14;475;Noyers-Bocage;1266;25;1291
14;027;Les Monts d'Aunay;14;477;Ondefontaine;320;4;324
14;011;Aurseulles;14;479;Orbois;157;1;158
14;342;Isigny-sur-Mer;14;481;Les Oubeaux;221;2;223
14;654;Saint-Pierre-en-Auge;14;489;Ouville-la-Bien-Tournée;249;3;252
14;431;Mézidon Vallée d'Auge;14;493;Percy-en-Auge;234;1;235
14;726;Valdallière;14;503;Pierres;213;8;221
14;150;Cesny-les-Sources;14;505;Placy;162;4;166
14;027;Les Monts d'Aunay;14;508;Le Plessis-Grimoult;325;7;332
14;005;Valambray;14;517;Poussy-la-Campagne;88;2;90
14;371;Livarot-Pays-d'Auge;14;518;Préaux-Saint-Sébastien;37;3;40
14;726;Valdallière;14;521;Presles;269;4;273
14;174;Condé-en-Normandie;14;523;Proussy;383;9;392
14;098;Thue et Mue;14;525;Putot-en-Bessin;418;1;419
14;527;Belle Vie en Auge;14;527;Biéville-Quétiéville;363;3;366
14;061;Souleuvre en Bocage;14;532;Le Reculey;298;7;305
14;046;Bavent;14;537;Robehomme;270;0;270
14;538;Castine-en-Plaine;14;538;Rocquancourt;1036;21;1057
14;726;Valdallière;14;539;La Rocque;84;0;84
14;543;Rots;14;543;Rots;1389;29;1418
14;027;Les Monts d'Aunay;14;544;Roucamps;222;2;224
14;762;Vire Normandie;14;545;Roullours;810;41;851
14;726;Valdallière;14;549;Rully;216;1;217
14;591;Aure sur Mer;14;551;Russy;176;3;179
14;554;Le Castelet;14;554;Saint-Aignan-de-Cramesnil;670;7;677
14;231;Beaufour-Druval;14;560;Saint-Aubin-Lébizay;113;3;116
14;726;Valdallière;14;564;Saint-Charles-de-Percy;195;2;197
14;098;Thue et Mue;14;568;Sainte-Croix-Grand-Tonne;326;3;329
14;570;Valorbiquet;14;570;Saint-Cyr-du-Ronceray;725;15;740
14;061;Souleuvre en Bocage;14;573;Saint-Denis-Maisoncelles;129;5;134
14;576;Val-de-Vie;14;576;Sainte-Foy-de-Montgommery;167;2;169
14;579;Seulline;14;579;Saint-Georges-d'Aunay;706;18;724
14;654;Saint-Pierre-en-Auge;14;580;Saint-Georges-en-Auge;82;2;84
14;011;Aurseulles;14;581;Saint-Germain-d'Ectot;314;6;320
14;576;Val-de-Vie;14;583;Saint-Germain-de-Montgommery;164;8;172
14;762;Vire Normandie;14;584;Saint-Germain-de-Tallevende-la-Lande-Vaumont;1961;98;2059
14;174;Condé-en-Normandie;14;585;Saint-Germain-du-Crioult;922;20;942
14;591;Aure sur Mer;14;591;Sainte-Honorine-des-Pertes;544;8;552
14;672;Val de Drôme;14;596;Saint-Jean-des-Essartiers;233;5;238
14;357;Terres de Druance;14;597;Saint-Jean-le-Blanc;350;6;356
14;570;Valorbiquet;14;599;Saint-Julien-de-Mailloc;473;2;475
14;431;Mézidon Vallée d'Auge;14;600;Saint-Julien-le-Faucon;686;9;695
14;527;Belle Vie en Auge;14;608;Saint-Loup-de-Fribois;180;5;185
14;658;Noues de Sienne;14;611;Saint-Manvieu-Bocage;541;17;558
14;371;Livarot-Pays-d'Auge;14;615;Sainte-Marguerite-des-Loges;178;1;179
14;654;Saint-Pierre-en-Auge;14;616;Sainte-Marguerite-de-Viette;333;4;337
14;061;Souleuvre en Bocage;14;618;Sainte-Marie-Laumont;683;19;702
14;689;Thury-Harcourt-le-Hom;14;628;Saint-Martin-de-Sallen;610;11;621
14;061;Souleuvre en Bocage;14;629;Saint-Martin-des-Besaces;1216;4;1220
14;061;Souleuvre en Bocage;14;632;Saint-Martin-Don;227;3;230
14;371;Livarot-Pays-d'Auge;14;633;Saint-Martin-du-Mesnil-Oury;108;3;111
14;371;Livarot-Pays-d'Auge;14;634;Saint-Michel-de-Livet;161;3;164
14;061;Souleuvre en Bocage;14;636;Saint-Ouen-des-Besaces;449;3;452
14;371;Livarot-Pays-d'Auge;14;638;Saint-Ouen-le-Houx;85;1;86
14;194;Courtonne-les-Deux-Églises;14;642;Saint-Paul-de-Courtonne;297;10;307
14;570;Valorbiquet;14;647;Saint-Pierre-de-Mailloc;496;13;509
14;174;Condé-en-Normandie;14;653;Saint-Pierre-la-Vieille;338;3;341
14;654;Saint-Pierre-en-Auge;14;654;Saint-Pierre-sur-Dives;3295;30;3325
14;061;Souleuvre en Bocage;14;655;Saint-Pierre-Tarentaine;364;4;368
14;658;Noues de Sienne;14;658;Saint-Sever-Calvados;1245;21;1266
14;357;Terres de Druance;14;662;Saint-Vigor-des-Mézerets;240;4;244
14;543;Rots;14;670;Secqueville-en-Bessin;440;6;446
14;658;Noues de Sienne;14;671;Sept-Frères;364;9;373
14;672;Val de Drôme;14;672;Sept-Vents;428;8;436
14;011;Aurseulles;14;673;Sermentot;301;4;305
14;228;Douvres-la-Délivrande;14;683;Tailleville;144;4;148
14;726;Valdallière;14;686;Le Theil-Bocage;195;2;197
14;654;Saint-Pierre-en-Auge;14;688;Thiéville;265;3;268
14;689;Thury-Harcourt-le-Hom;14;689;Thury-Harcourt;1994;25;2019
14;538;Castine-en-Plaine;14;691;Tilly-la-Campagne;259;5;264
14;570;Valorbiquet;14;693;Tordouet;272;8;280
14;011;Aurseulles;14;695;Torteval-Quesnay;333;3;336
14;371;Livarot-Pays-d'Auge;14;696;Tortisambert;124;3;127
14;475;Val d'Arry;14;702;Tournay-sur-Odon;344;9;353
14;150;Cesny-les-Sources;14;703;Tournebu;357;6;363
14;061;Souleuvre en Bocage;14;704;Le Tourneur;650;10;660
14;762;Vire Normandie;14;717;Truttemer-le-Grand;635;32;667
14;762;Vire Normandie;14;718;Truttemer-le-Petit;122;6;128
14;143;Caumont-sur-Aure;14;722;La Vacquerie;308;3;311
14;333;Honfleur;14;725;Vasouy;105;2;107
14;726;Valdallière;14;726;Vassy;1695;37;1732
14;035;Balleroy-sur-Drôme;14;727;Vaubadon;421;4;425
14;654;Saint-Pierre-en-Auge;14;729;Vaudeloges;191;3;194
14;762;Vire Normandie;14;730;Vaudry;1428;72;1500
14;726;Valdallière;14;746;Viessoix;772;22;794
14;431;Mézidon Vallée d'Auge;14;749;Vieux-Fumé;516;6;522
14;654;Saint-Pierre-en-Auge;14;750;Vieux-Pont-en-Auge;270;7;277
14;762;Vire Normandie;14;762;Vire;10749;539;11288
14;342;Isigny-sur-Mer;14;763;Vouilly;148;4;152
15;027;Puycapel;15;027;Calvinet;429;10;439
15;141;Neussargues en Pinatelle;15;031;Celles;246;9;255
15;141;Neussargues en Pinatelle;15;035;Chalinargues;342;5;347
15;138;Murat;15;044;Chastel-sur-Murat;117;5;122
15;141;Neussargues en Pinatelle;15;047;Chavagnac;99;3;102
15;003;Ally;15;062;Drignac;75;0;75
15;108;Val d'Arcomie;15;068;Faverolles;292;10;302
15;181;Saint-Constant-Fournoulès;15;071;Fournoulès;61;1;62
15;142;Neuvéglise-sur-Truyère;15;099;Lavastrie;264;5;269
15;108;Val d'Arcomie;15;108;Loubaresse;429;10;439
15;153;Pleaux;15;109;Loupiac;177;2;179
15;038;Champs-sur-Tarentaine-Marchal;15;115;Marchal;77;0;77
15;027;Puycapel;15;136;Mourjou;310;4;314
15;138;Murat;15;138;Murat;1698;93;1791
15;141;Neussargues en Pinatelle;15;141;Neussargues-Moissac;904;18;922
15;142;Neuvéglise-sur-Truyère;15;142;Neuvéglise;1082;27;1109
15;142;Neuvéglise-sur-Truyère;15;145;Oradour;224;7;231
15;268;Le Rouget-Pers;15;150;Pers;270;8;278
15;141;Neussargues en Pinatelle;15;171;Sainte-Anastasie;137;2;139
15;153;Pleaux;15;177;Saint-Christophe-les-Gorges;133;5;138
15;181;Saint-Constant-Fournoulès;15;181;Saint-Constant;513;10;523
15;108;Val d'Arcomie;15;195;Saint-Just;191;1;192
15;108;Val d'Arcomie;15;197;Saint-Marc;82;1;83
15;202;Saint-Martin-Valmeroux;15;210;Saint-Rémy-de-Salers;62;2;64
15;142;Neuvéglise-sur-Truyère;15;227;Sériers;150;5;155
15;153;Pleaux;15;239;Tourniac;126;1;127
15;268;Le Rouget-Pers;15;268;Le Rouget;998;17;1015
16;005;Aigre;16;005;Aigre;1064;12;1076
16;186;Lignières-Ambleville;16;010;Ambleville;164;4;168
16;339;Val-d'Auge;16;017;Anville;215;3;218
16;339;Val-d'Auge;16;051;Bonneville;136;5;141
16;082;Boisné-La Tude;16;082;Charmant;337;5;342
16;082;Boisné-La Tude;16;092;Chavenat;180;7;187
16;106;Confolens;16;106;Confolens;2651;151;2802
16;110;Courcôme;16;110;Courcôme;379;11;390
16;253;Paizay-Naudouin-Embourie;16;126;Embourie;75;1;76
16;204;Bellevigne;16;129;Éraville;198;3;201
16;192;Terres-de-Haute-Charente;16;149;Genouillac;642;7;649
16;153;Mainxe-Gondeville;16;153;Gondeville;502;4;506
16;286;Rouillac;16;156;Gourville;632;6;638
16;082;Boisné-La Tude;16;172;Juillaguet;150;1;151
16;224;Montmérac;16;179;Lamérac;224;5;229
16;186;Lignières-Ambleville;16;186;Lignières-Sonneville;548;17;565
16;192;Terres-de-Haute-Charente;16;192;Roumazières-Loubert;2404;39;2443
16;153;Mainxe-Gondeville;16;202;Mainxe;669;18;687
16;204;Bellevigne;16;204;Malaville;401;17;418
16;192;Terres-de-Haute-Charente;16;214;Mazières;91;6;97
16;224;Montmérac;16;224;Montchaude;493;13;506
16;339;Val-d'Auge;16;228;Montigné;184;5;189
16;233;Mosnac-Saint-Simeux;16;233;Mosnac;446;5;451
16;204;Bellevigne;16;247;Nonaville;198;6;204
16;192;Terres-de-Haute-Charente;16;259;La Péruse;492;51;543
16;286;Rouillac;16;262;Plaizac;137;2;139
16;097;Cherves-Richemont;16;278;Richemont;403;38;441
16;281;La Rochefoucauld-en-Angoumois;16;281;La Rochefoucauld;2897;49;2946
16;286;Rouillac;16;286;Rouillac;1958;31;1989
16;287;Roullet-Saint-Estèphe;16;313;Saint-Estèphe;880;11;891
16;106;Confolens;16;322;Saint-Germain-de-Confolens;69;2;71
16;028;Barbezieux-Saint-Hilaire;16;327;Saint-Hilaire;321;4;325
16;339;Val-d'Auge;16;339;Auge-Saint-Médard;267;3;270
16;281;La Rochefoucauld-en-Angoumois;16;344;Saint-Projet-Saint-Constant;1087;80;1167
16;233;Mosnac-Saint-Simeux;16;351;Saint-Simeux;556;12;568
16;286;Rouillac;16;371;Sonneville;213;4;217
16;192;Terres-de-Haute-Charente;16;376;Suris;238;1;239
16;204;Bellevigne;16;386;Touzac;384;6;390
16;110;Courcôme;16;391;Tuzie;185;5;190
16;110;Courcôme;16;410;Villegats;212;5;217
16;005;Aigre;16;411;Villejésus;531;8;539
16;204;Bellevigne;16;417;Viville;101;1;102
17;397;Saint-Savinien;17;001;Agonnay;66;0;66
17;277;Essouvert;17;040;La Benâte;370;13;383
17;240;Montendre;17;090;Chardes;299;3;302
17;397;Saint-Savinien;17;123;Coulonge-sur-Charente;121;0;121
17;026;Authon-Ébéon;17;144;Ébéon;49;0;49
17;344;Saint-Hilaire-de-Villefranche;17;169;La Frédière;72;2;74
17;219;Marennes-Hiers-Brouage;17;189;Hiers-Brouage;647;4;651
17;219;Marennes-Hiers-Brouage;17;219;Marennes;5556;97;5653
17;340;Saint-Pierre-La-Noue;17;272;Péré;357;5;362
17;277;Essouvert;17;277;Saint-Denis-du-Pin;689;68;757
17;340;Saint-Pierre-La-Noue;17;340;Saint-Germain-de-Marencennes;1160;86;1246
17;344;Saint-Hilaire-de-Villefranche;17;344;Saint-Hilaire-de-Villefranche;1256;24;1280
17;240;Montendre;17;456;Vallet;261;5;266
18;023;Baugy;18;023;Baugy;1420;48;1468
19;010;Argentat-sur-Dordogne;19;010;Argentat;2752;112;2864
19;019;Beaulieu-sur-Dordogne;19;019;Beaulieu-sur-Dordogne;1100;13;1113
19;019;Beaulieu-sur-Dordogne;19;032;Brivezac;190;2;192
19;098;Lagarde-Marc-la-Tour;19;098;Lagarde-Enval;816;18;834
19;101;Laguenne-sur-Avalouze;19;101;Laguenne;1337;44;1381
19;123;Malemort;19;123;Malemort-sur-Corrèze;7548;158;7706
19;098;Lagarde-Marc-la-Tour;19;127;Marc-la-Tour;142;5;147
19;010;Argentat-sur-Dordogne;19;183;Saint-Bazile-de-la-Roche;135;1;136
19;101;Laguenne-sur-Avalouze;19;185;Saint-Bonnet-Avalouze;204;3;207
19;275;Ussel;19;197;Saint-Dézery;153;3;156
19;275;Ussel;19;267;La Tourette;198;5;203
19;123;Malemort;19;282;Venarsal;502;8;510
21;272;Le Val-Larrey;21;073;Bierre-lès-Semur;94;1;95
21;183;Collonges-et-Premières;21;183;Collonges-lès-Premières;923;12;935
21;452;Neuilly-Crimolois;21;213;Crimolois;1043;17;1060
21;272;Le Val-Larrey;21;272;Flée;173;4;177
21;352;Longeault-Pluvault;21;352;Longeault;541;10;551
21;433;Montigny-Mornay-Villeneuve-sur-Vingeanne;21;443;Mornay;80;0;80
21;452;Neuilly-Crimolois;21;452;Neuilly-lès-Dijon;2061;20;2081
21;304;Grancey-le-Château-Neuvelle;21;453;Neuvelle-lès-Grancey;23;0;23
21;352;Longeault-Pluvault;21;486;Pluvault;602;13;615
21;183;Collonges-et-Premières;21;507;Premières;141;1;142
21;623;Tart;21;621;Tart-l'Abbaye;188;8;196
21;623;Tart;21;623;Tart-le-Haut;1375;23;1398
21;433;Montigny-Mornay-Villeneuve-sur-Vingeanne;21;697;La Villeneuve-sur-Vingeanne;76;2;78
22;055;Binic-Étables-sur-Mer;22;007;Binic;3748;121;3869
22;206;Châtelaudren-Plouagat;22;038;Châtelaudren;1021;12;1033
22;046;Le Mené;22;046;Collinée;987;21;1008
22;084;Jugon-les-Lacs - Commune nouvelle;22;051;Dolo;708;23;731
22;055;Binic-Étables-sur-Mer;22;055;Étables-sur-Mer;3114;92;3206
22;183;Plémet;22;058;La Ferrière;430;7;437
22;046;Le Mené;22;066;Le Gouray;1288;13;1301
22;264;La Roche-Jaudy;22;078;Hengoat;242;4;246
22;203;Plœuc-L'Hermitage;22;080;L'Hermitage-Lorge;692;12;704
22;084;Jugon-les-Lacs - Commune nouvelle;22;084;Jugon-les-Lacs;1825;27;1852
22;093;Lamballe-Armor;22;093;Lamballe;12518;360;12878
22;219;Plouguenast-Langast;22;100;Langast;573;16;589
22;046;Le Mené;22;102;Langourla;535;9;544
22;107;Bon Repos sur Blavet;22;107;Laniscat;759;24;783
22;050;Dinan;22;123;Léhon;3206;125;3331
22;093;Lamballe-Armor;22;151;Meslin;941;27;968
22;093;Lamballe-Armor;22;154;Morieux;1034;30;1064
22;158;Guerlédan;22;158;Mûr-de-Bretagne;2038;50;2088
22;107;Bon Repos sur Blavet;22;167;Perret;170;5;175
22;093;Lamballe-Armor;22;173;Planguenoual;2196;63;2259
22;183;Plémet;22;183;Plémet;3144;51;3195
22;046;Le Mené;22;191;Plessala;1741;34;1775
22;209;Beaussais-sur-Mer;22;192;Plessix-Balisson;73;3;76
22;203;Plœuc-L'Hermitage;22;203;Plœuc-sur-Lié;3416;58;3474
22;206;Châtelaudren-Plouagat;22;206;Plouagat;2934;43;2977
22;209;Beaussais-sur-Mer;22;209;Ploubalay;3547;54;3601
22;219;Plouguenast-Langast;22;219;Plouguenast;1856;41;1897
22;264;La Roche-Jaudy;22;247;Pommerit-Jaudy;1203;583;1786
22;264;La Roche-Jaudy;22;253;Pouldouran;156;2;158
22;264;La Roche-Jaudy;22;264;La Roche-Derrien;1070;22;1092
22;107;Bon Repos sur Blavet;22;290;Saint-Gelven;320;7;327
22;046;Le Mené;22;292;Saint-Gilles-du-Mené;448;14;462
22;046;Le Mené;22;297;Saint-Gouéno;685;14;699
22;158;Guerlédan;22;298;Saint-Guen;429;13;442
22;046;Le Mené;22;303;Saint-Jacut-du-Mené;728;10;738
22;209;Beaussais-sur-Mer;22;357;Trégon;336;6;342
23;093;Gouzon;23;094;Gouzougnat;111;4;115
23;189;Saint-Dizier-Masbaraud;23;126;Masbaraud-Mérignat;351;15;366
23;149;Parsac-Rimondeix;23;149;Parsac;627;13;640
23;090;Gentioux-Pigerolles;23;153;Pigerolles;67;1;68
23;149;Parsac-Rimondeix;23;161;Rimondeix;85;1;86
23;189;Saint-Dizier-Masbaraud;23;189;Saint-Dizier-Leyrenne;780;10;790
24;053;Boulazac Isle Manoire;24;013;Atur;1931;63;1994
24;026;Bassillac et Auberoche;24;026;Bassillac;1863;41;1904
24;028;Beaumontois en Périgord;24;028;Beaumont-du-Périgord;1005;20;1025
24;253;Mareuil en Périgord;24;033;Beaussac;154;2;156
24;035;Pays de Belvès;24;035;Belvès;1226;36;1262
24;026;Bassillac et Auberoche;24;044;Blis-et-Born;466;3;469
24;147;Cubjac-Auvézère-Val d'Ans;24;047;La Boissière-d'Ans;222;1;223
24;053;Boulazac Isle Manoire;24;053;Boulazac;7158;235;7393
24;064;Brantôme en Périgord;24;064;Brantôme en Périgord;2055;33;2088
24;312;Sanilhac;24;065;Breuilh;273;2;275
24;068;Le Buisson-de-Cadouin;24;072;Cadouin;312;7;319
24;064;Brantôme en Périgord;24;079;Cantillac;183;5;188
24;325;Pechs-de-l'Espérance;24;089;Cazoulès;449;12;461
24;362;Val de Louyre et Caudeau;24;092;Cendrieux;601;6;607
24;554;La Tour-Blanche-Cercles;24;093;Cercles;178;7;185
24;253;Mareuil en Périgord;24;099;Champeaux-et-la-Chapelle-Pommier;152;0;152
24;026;Bassillac et Auberoche;24;103;Le Change;627;10;637
24;086;Castelnaud-la-Chapelle;24;112;La Chapelle-Péchaud;117;0;117
24;117;Les Coteaux Périgourdins;24;117;Chavagnac;367;9;376
24;316;Parcoul-Chenaud;24;118;Chenaud;365;9;374
24;364;Coly-Saint-Amand;24;127;Coly;200;3;203
24;147;Cubjac-Auvézère-Val d'Ans;24;147;Cubjac;730;10;740
24;026;Bassillac et Auberoche;24;166;Eyliac;719;16;735
24;064;Brantôme en Périgord;24;170;Eyvirat;298;6;304
24;172;Les Eyzies;24;172;Les Eyzies-de-Tayac-Sireuil;831;14;845
24;064;Brantôme en Périgord;24;198;La Gonterie-Boulouneix;224;3;227
24;260;Mauzac-et-Grand-Castang;24;201;Grand-Castang;95;1;96
24;253;Mareuil en Périgord;24;203;Les Graulges;77;0;77
24;117;Les Coteaux Périgourdins;24;204;Grèzes;196;9;205
24;216;La Jemaye-Ponteyraud;24;216;La Jemaye;110;1;111
24;028;Beaumontois en Périgord;24;219;Labouquerie;213;3;216
24;259;Eyraud-Crempse-Maurens;24;233;Laveyssière;147;0;147
24;253;Mareuil en Périgord;24;235;Léguillac-de-Cercles;258;5;263
24;540;Sorges et Ligueux en Périgord;24;239;Ligueux;298;3;301
24;172;Les Eyzies;24;249;Manaurie;146;3;149
24;253;Mareuil en Périgord;24;253;Mareuil;1044;16;1060
24;312;Sanilhac;24;258;Marsaneix;1144;20;1164
24;259;Eyraud-Crempse-Maurens;24;259;Maurens;1055;20;1075
24;026;Bassillac et Auberoche;24;270;Milhac-d'Auberoche;552;8;560
24;253;Mareuil en Périgord;24;283;Monsec;168;5;173
24;028;Beaumontois en Périgord;24;310;Nojals-et-Clotte;197;3;200
24;312;Sanilhac;24;312;Notre-Dame-de-Sanilhac;3248;82;3330
24;325;Pechs-de-l'Espérance;24;314;Orliaguet;110;9;119
24;068;Le Buisson-de-Cadouin;24;315;Paleyrac;181;9;190
24;316;Parcoul-Chenaud;24;316;Parcoul;431;7;438
24;325;Pechs-de-l'Espérance;24;325;Peyrillac-et-Millac;201;5;206
24;216;La Jemaye-Ponteyraud;24;333;Ponteyraud;42;3;45
24;376;Saint Aulaye-Puymangou;24;343;Puymangou;69;0;69
24;253;Mareuil en Périgord;24;344;Puyrenier;54;1;55
24;362;Val de Louyre et Caudeau;24;362;Sainte-Alvère;770;10;780
24;035;Pays de Belvès;24;363;Saint-Amand-de-Belvès;111;0;111
24;364;Coly-Saint-Amand;24;364;Saint-Amand-de-Coly;388;13;401
24;026;Bassillac et Auberoche;24;369;Saint-Antoine-d'Auberoche;137;5;142
24;376;Saint Aulaye-Puymangou;24;376;Saint-Aulaye;1353;19;1372
24;356;Rouffignac-Saint-Cernin-de-Reilhac;24;387;Saint-Cernin-de-Reillac;129;2;131
24;172;Les Eyzies;24;389;Saint-Cirq;132;3;135
24;064;Brantôme en Périgord;24;391;Saint-Crépin-de-Richemont;233;5;238
24;423;Saint-Julien-Innocence-Eulalie;24;402;Sainte-Eulalie-d'Eymet;81;1;82
24;423;Saint-Julien-Innocence-Eulalie;24;423;Sainte-Innocence;114;1;115
24;259;Eyraud-Crempse-Maurens;24;427;Saint-Jean-d'Eyraud;172;7;179
24;064;Brantôme en Périgord;24;430;Saint-Julien-de-Bourdeilles;91;0;91
24;259;Eyraud-Crempse-Maurens;24;431;Saint-Julien-de-Crempse;213;1;214
24;423;Saint-Julien-Innocence-Eulalie;24;433;Saint-Julien-d'Eymet;115;0;115
24;362;Val de Louyre et Caudeau;24;435;Saint-Laurent-des-Bâtons;217;5;222
24;053;Boulazac Isle Manoire;24;439;Saint-Laurent-sur-Manoire;1076;35;1111
24;053;Boulazac Isle Manoire;24;447;Sainte-Marie-de-Chignac;573;19;592
24;354;La Roche-Chalais;24;467;Saint-Michel-de-Rivière;809;15;824
24;354;La Roche-Chalais;24;469;Saint-Michel-l'Écluse-et-Léparon;625;10;635
24;147;Cubjac-Auvézère-Val d'Ans;24;475;Saint-Pantaly-d'Ans;148;1;149
24;028;Beaumontois en Périgord;24;497;Sainte-Sabine-Born;388;9;397
24;253;Mareuil en Périgord;24;503;Saint-Sulpice-de-Mareuil;74;2;76
24;064;Brantôme en Périgord;24;530;Sencenac-Puy-de-Fourches;275;3;278
24;540;Sorges et Ligueux en Périgord;24;540;Sorges;1303;26;1329
24;554;La Tour-Blanche-Cercles;24;554;La Tour-Blanche;385;7;392
24;064;Brantôme en Périgord;24;561;Valeuil;335;13;348
24;253;Mareuil en Périgord;24;579;Vieux-Mareuil;309;10;319
25;223;Éternoz;25;010;Alaise;41;1;42
25;035;Les Auxons;25;034;Auxon-Dessous;1367;19;1386
25;035;Les Auxons;25;035;Auxon-Dessus;1145;27;1172
25;433;Orgeans-Blanchefontaine;25;064;Blanchefontaine;3;0;3
25;434;Ornans;25;076;Bonnevaux-le-Prieuré;118;3;121
25;156;Pays-de-Clerval;25;140;Chaux-lès-Clerval;155;4;159
25;505;Rougemont;25;144;Chazelot;52;2;54
25;101;Burgille;25;146;Chazoy;58;2;60
25;101;Burgille;25;165;Cordiron;123;2;125
25;374;Mercey-le-Grand;25;167;Cottier;95;6;101
25;223;Éternoz;25;168;Coulans-sur-Lizon;22;0;22
25;223;Éternoz;25;205;Doulaize;20;0;20
25;018;Anteuil;25;272;Glainans;124;7;131
25;417;Naisey-les-Granges;25;291;Granges-de-Vienney;29;1;30
25;357;Maisons-du-Bois-Lièvremont;25;337;Lièvremont;427;6;433
25;468;Pouligney-Lusans;25;353;Lusans;173;5;178
25;537;Scey-Maisières;25;358;Maisières-Notre-Dame;70;4;74
25;187;Dambelin;25;363;Mambouhans;57;1;58
25;505;Rougemont;25;396;Montferney;54;2;56
25;275;Glère;25;407;Montursin;6;0;6
25;505;Rougemont;25;409;Morchamps;15;0;15
25;434;Ornans;25;434;Ornans;4304;103;4407
25;438;Osselle-Routelle;25;438;Osselle;447;5;452
25;223;Éternoz;25;484;Refranche;18;1;19
25;438;Osselle-Routelle;25;509;Routelle;512;10;522
25;385;Montagney-Servigney;25;543;Servigney;50;0;50
25;018;Anteuil;25;568;Tournedoz;22;0;22
25;212;École-Valentin;25;581;Valentin;340;4;344
25;275;Glère;25;606;Vernois-le-Fol;67;2;69
26;001;Solaure en Diois;26;001;Aix-en-Diois;332;7;339
26;086;Châtillon-en-Diois;26;086;Châtillon-en-Diois;546;10;556
26;210;Valherbasse;26;184;Miribel;298;3;301
26;001;Solaure en Diois;26;187;Molières-Glandaz;96;1;97
26;210;Valherbasse;26;210;Montrigaud;492;9;501
26;216;Saint-Jean-de-Galaure;26;216;La Motte-de-Galaure;796;14;810
26;216;Saint-Jean-de-Galaure;26;219;Mureils;479;10;489
26;210;Valherbasse;26;297;Saint-Bonnet-de-Valclérieux;231;5;236
26;086;Châtillon-en-Diois;26;354;Treschenu-Creyers;112;2;114
26;179;Mercurol-Veaunes;26;366;Veaunes;366;7;373
27;049;Mesnil-en-Ouche;27;007;Ajou;258;3;261
27;011;Amfreville-Saint-Amand;27;011;Amfreville-la-Campagne;913;9;922
27;022;Le Val d'Hazey;27;022;Aubevoye;4752;99;4851
27;198;Mesnils-sur-Iton;27;024;Le Roncenay-Authenay;332;5;337
27;049;Mesnil-en-Ouche;27;041;La Barre-en-Ouche;836;21;857
27;049;Mesnil-en-Ouche;27;049;Beaumesnil;482;34;516
27;213;Vexin-sur-Epte;27;060;Berthenonville;245;2;247
27;062;Les Monts du Roumois;27;062;Berville-en-Roumois;859;27;886
27;070;Frenelles-en-Vexin;27;070;Boisemont;797;8;805
27;085;Flancourt-Crescy-en-Roumois;27;085;Bosc-Bénard-Crescy;460;4;464
27;049;Mesnil-en-Ouche;27;088;Bosc-Renoult-en-Ouche;136;4;140
27;090;Bosroumois;27;090;Le Bosc-Roger-en-Roumois;3316;60;3376
27;062;Les Monts du Roumois;27;092;Bosguérard-de-Marcouville;624;17;641
27;090;Bosroumois;27;093;Bosnormand;402;8;410
27;107;Bourneville-Sainte-Croix;27;107;Bourneville;1039;18;1057
27;112;Breteuil;27;112;Breteuil;3093;107;3200
27;213;Vexin-sur-Epte;27;121;Bus-Saint-Rémy;339;6;345
27;213;Vexin-sur-Epte;27;122;Cahaignes;344;9;353
27;213;Vexin-sur-Epte;27;128;Cantiers;225;4;229
27;425;Nassandres sur Risle;27;131;Carsix;271;3;274
27;685;La Vieille-Lyre;27;143;Champignolles;38;2;40
27;112;Breteuil;27;159;Cintray;446;4;450
27;213;Vexin-sur-Epte;27;160;Civières;218;8;226
27;198;Mesnils-sur-Iton;27;166;Condé-sur-Iton;920;11;931
27;070;Frenelles-en-Vexin;27;175;Corny;388;4;392
27;578;Sainte-Marie-d'Attez;27;195;Dame-Marie;128;3;131
27;213;Vexin-sur-Epte;27;197;Dampsmesnil;196;5;201
27;198;Mesnils-sur-Iton;27;198;Damville;2090;28;2118
27;213;Vexin-sur-Epte;27;213;Écos;1068;14;1082
27;049;Mesnil-en-Ouche;27;221;Épinay;294;5;299
27;425;Nassandres sur Risle;27;253;Fontaine-la-Soret;378;7;385
27;213;Vexin-sur-Epte;27;255;Fontenay-en-Vexin;251;4;255
27;213;Vexin-sur-Epte;27;257;Forêt-la-Folie;480;18;498
27;213;Vexin-sur-Epte;27;262;Fourges;759;16;775
27;263;Le Perrey;27;263;Fourmetot;682;11;693
27;213;Vexin-sur-Epte;27;264;Fours-en-Vexin;193;4;197
27;679;Verneuil d'Avre et d'Iton;27;265;Francheville;1174;21;1195
27;070;Frenelles-en-Vexin;27;270;Fresne-l'Archevêque;529;15;544
27;294;Val d'Orger;27;274;Gaillardbois-Cressenville;443;7;450
27;277;La Baronnie;27;277;Garencières;607;13;620
27;049;Mesnil-en-Ouche;27;283;Gisay-la-Coudre;241;6;247
27;049;Mesnil-en-Ouche;27;292;Gouttières;178;2;180
27;198;Mesnils-sur-Iton;27;293;Gouville;591;128;719
27;294;Val d'Orger;27;294;Grainville;550;8;558
27;049;Mesnil-en-Ouche;27;296;Granchain;219;5;224
27;198;Mesnils-sur-Iton;27;297;Grandvilliers;315;3;318
27;112;Breteuil;27;305;La Guéroulde;782;13;795
27;213;Vexin-sur-Epte;27;308;Guitry;255;4;259
27;062;Les Monts du Roumois;27;344;Houlbec-près-le-Gros-Theil;88;1;89
27;049;Mesnil-en-Ouche;27;356;Jonquerets-de-Livet;332;5;337
27;049;Mesnil-en-Ouche;27;362;Landepéreuse;379;10;389
27;198;Mesnils-sur-Iton;27;387;Manthelon;330;3;333
27;412;Terres de Bord;27;412;Montaure;1100;24;1124
27;198;Mesnils-sur-Iton;27;416;Buis-sur-Damville;1022;23;1045
27;425;Nassandres sur Risle;27;425;Nassandres;1302;24;1326
27;448;Pacy-sur-Eure;27;448;Pacy-sur-Eure;4540;115;4655
27;213;Vexin-sur-Epte;27;449;Panilleuse;461;10;471
27;425;Nassandres sur Risle;27;452;Perriers-la-Campagne;415;6;421
27;471;Porte-de-Seine;27;471;Porte-Joie;100;3;103
27;153;Chauvincourt-Provemont;27;479;Provemont;141;3;144
27;277;La Baronnie;27;484;Quessigny;141;2;143
27;198;Mesnils-sur-Iton;27;491;Roman;243;8;251
27;049;Mesnil-en-Ouche;27;499;La Roussière;212;5;217
27;198;Mesnils-sur-Iton;27;503;Le Sacq;306;7;313
27;011;Amfreville-Saint-Amand;27;506;Saint-Amand-des-Hautes-Terres;284;4;288
27;448;Pacy-sur-Eure;27;510;Saint-Aquilin-de-Pacy;502;11;513
27;049;Mesnil-en-Ouche;27;513;Saint-Aubin-des-Hayes;146;6;152
27;049;Mesnil-en-Ouche;27;515;Saint-Aubin-le-Guichard;288;7;295
27;516;Treis-Sants-en-Ouche;27;516;Saint-Aubin-le-Vertueux;812;19;831
27;022;Le Val d'Hazey;27;519;Sainte-Barbe-sur-Gaillon;310;4;314
27;516;Treis-Sants-en-Ouche;27;523;Saint-Clair-d'Arcey;356;12;368
27;107;Bourneville-Sainte-Croix;27;526;Sainte-Croix-sur-Aizier;297;6;303
27;049;Mesnil-en-Ouche;27;566;Sainte-Marguerite-en-Ouche;95;1;96
27;578;Sainte-Marie-d'Attez;27;573;Saint-Nicolas-d'Attez;168;6;174
27;578;Sainte-Marie-d'Attez;27;578;Saint-Ouen-d'Attez;295;3;298
27;263;Le Perrey;27;581;Saint-Ouen-des-Champs;312;8;320
27;049;Mesnil-en-Ouche;27;596;Saint-Pierre-du-Mesnil;90;0;90
27;516;Treis-Sants-en-Ouche;27;600;Saint-Quentin-des-Isles;218;3;221
27;263;Le Perrey;27;607;Saint-Thurien;242;1;243
27;049;Mesnil-en-Ouche;27;628;Thevray;298;5;303
27;412;Terres de Bord;27;648;Tostes;420;8;428
27;471;Porte-de-Seine;27;651;Tournedos-sur-Seine;107;2;109
27;213;Vexin-sur-Epte;27;653;Tourny;930;31;961
27;679;Verneuil d'Avre et d'Iton;27;679;Verneuil-sur-Avre;6200;322;6522
27;022;Le Val d'Hazey;27;687;Vieux-Villez;186;3;189
28;199;Janville-en-Beauce;28;002;Allaines-Mervilliers;251;6;257
28;023;Bailleau-Armenonville;28;011;Armenonville-les-Gâtineaux;283;12;295
28;015;Auneau-Bleury-Saint-Symphorien;28;015;Auneau;4918;69;4987
28;018;Authon-du-Perche;28;018;Authon-du-Perche;1160;12;1172
28;406;Éole-en-Beauce;28;020;Baignolet;111;6;117
28;226;Maillebois;28;043;Blévy;363;6;369
28;236;Arcisses;28;063;Brunelles;509;8;517
28;236;Arcisses;28;112;Coudreceau;478;9;487
28;226;Maillebois;28;125;Dampierre-sur-Blévy;245;5;250
28;406;Éole-en-Beauce;28;145;Fains-la-Folie;343;6;349
28;331;Saintigny;28;165;Frétigny;496;10;506
28;386;Thimert-Gâtelles;28;174;Gâtelles;396;6;402
28;406;Éole-en-Beauce;28;179;Germignonville;224;3;227
28;199;Janville-en-Beauce;28;199;Janville;1890;29;1919
28;120;Crucey-Villages;28;228;Mainterne;72;0;72
28;236;Arcisses;28;236;Margon;1203;25;1228
28;360;Saint-Sauveur-Marville;28;238;Marville-les-Bois;366;9;375
28;422;Les Villages Vovéens;28;258;Montainville;301;6;307
28;056;Boutigny-Prouais;28;307;Prouais;557;12;569
28;199;Janville-en-Beauce;28;311;Le Puiset;400;9;409
28;422;Les Villages Vovéens;28;320;Rouvray-Saint-Florentin;207;3;210
28;331;Saintigny;28;331;Saint-Denis-d'Authou;453;9;462
28;034;Berchères-Saint-Germain;28;338;Saint-Germain-la-Gâtine;161;1;162
28;015;Auneau-Bleury-Saint-Symphorien;28;361;Bleury-Saint-Symphorien;1312;25;1337
28;018;Authon-du-Perche;28;376;Soizé;332;4;336
28;373;Senonches;28;381;Tardais;56;0;56
28;279;Nogent-le-Roi;28;399;Vacheresses-les-Basses;248;10;258
28;406;Éole-en-Beauce;28;406;Viabon;381;1;382
28;406;Éole-en-Beauce;28;412;Villeau;185;3;188
28;373;Senonches;28;413;La Ville-aux-Nonains;161;2;163
28;422;Les Villages Vovéens;28;416;Villeneuve-Saint-Nicolas;139;4;143
28;120;Crucey-Villages;28;420;Vitray-sous-Brézolles;80;0;80
28;422;Les Villages Vovéens;28;422;Voves;3285;48;3333
29;003;Audierne;29;003;Audierne;2151;35;2186
29;021;Plounéour-Brignogan-plages;29;021;Brignogan-Plages;740;18;758
29;003;Audierne;29;052;Esquibien;1539;31;1570
29;076;Milizac-Guipronvel;29;076;Guipronvel;817;6;823
29;241;Rosporden;29;092;Kernével;3173;70;3243
29;266;Saint-Thégonnec Loc-Eguiner;29;127;Loc-Eguiner-Saint-Thégonnec;322;5;327
29;227;Poullaouen;29;129;Locmaria-Berrien;223;4;227
29;076;Milizac-Guipronvel;29;149;Milizac;3789;59;3848
29;199;Plouigneau;29;199;Plouigneau;4898;164;5062
29;021;Plounéour-Brignogan-plages;29;203;Plounéour-Trez;1186;36;1222
29;199;Plouigneau;29;219;Le Ponthou;184;3;187
29;227;Poullaouen;29;227;Poullaouen;1250;29;1279
29;266;Saint-Thégonnec Loc-Eguiner;29;266;Saint-Thégonnec;2737;74;2811
31;085;Boutx;31;016;Argut-Dessus;43;0;43
31;085;Boutx;31;154;Couledoux;39;0;39
31;471;Saint-Béat-Lez;31;298;Lez;50;0;50
31;412;Péguilhan;31;307;Lunax;61;1;62
31;412;Péguilhan;31;412;Péguilhan;202;7;209
32;426;Seissan;32;011;Artiguedieu;96;0;96
32;344;Riscle;32;074;Cannet;353;12;365
32;079;Castelnau d'Auzan Labarrère;32;168;Labarrère;189;6;195
32;462;Vic-Fezensac;32;179;Lagraulas;104;3;107
32;344;Riscle;32;344;Riscle;1408;110;1518
33;018;Val de Virvée;33;018;Aubie-et-Espessas;1423;18;1441
33;106;Castets et Castillon;33;106;Castets-en-Dorthe;1208;23;1231
33;106;Castets et Castillon;33;107;Castillon-de-Castets;279;9;288
33;380;Val-de-Livenne;33;267;Marcillac;1120;15;1135
33;018;Val de Virvée;33;371;Saint-Antoine;438;5;443
33;380;Val-de-Livenne;33;380;Saint-Caprais-de-Blaye;666;8;674
33;018;Val de Virvée;33;495;Salignac;1840;20;1860
34;246;Entre-Vignes;34;246;Saint-Christol;1396;23;1419
34;246;Entre-Vignes;34;330;Vérargues;737;14;751
35;004;Val-Couesnon;35;004;Antrain;1286;23;1309
35;292;Saint-Marc-le-Blanc;35;011;Baillé;270;7;277
35;168;Val d'Anast;35;048;Campel;455;11;466
35;220;Piré-Chancé;35;053;Chancé;314;14;328
35;069;Châteaugiron;35;069;Châteaugiron;8359;218;8577
35;096;Domagné;35;074;Chaumeré;183;5;188
35;191;Les Portes du Coglais;35;083;Coglès;637;14;651
35;163;Luitré-Dompierre;35;100;Dompierre-du-Chemin;541;9;550
35;004;Val-Couesnon;35;113;La Fontenelle;520;13;533
35;308;Mesnil-Roc'h;35;147;Lanhélin;950;12;962
35;163;Luitré-Dompierre;35;163;Luitré;1277;21;1298
35;168;Val d'Anast;35;168;Maure-de-Bretagne;3488;71;3559
35;184;Montauban-de-Bretagne;35;184;Montauban-de-Bretagne;5632;233;5865
35;191;Les Portes du Coglais;35;191;Montours;1072;22;1094
35;069;Châteaugiron;35;209;Ossé;1310;25;1335
35;220;Piré-Chancé;35;220;Piré-sur-Seiche;2782;42;2824
35;069;Châteaugiron;35;254;Saint-Aubin-du-Pavail;872;24;896
35;257;Maen Roch;35;257;Saint-Brice-en-Coglès;3135;52;3187
35;257;Maen Roch;35;267;Saint-Étienne-en-Coglès;1898;41;1939
35;282;Rives-du-Couesnon;35;269;Saint-Georges-de-Chesné;707;11;718
35;282;Rives-du-Couesnon;35;282;Saint-Jean-sur-Couesnon;1224;28;1252
35;292;Saint-Marc-le-Blanc;35;292;Saint-Marc-le-Blanc;1335;36;1371
35;282;Rives-du-Couesnon;35;293;Saint-Marc-sur-Couesnon;575;8;583
35;184;Montauban-de-Bretagne;35;301;Saint-M'Hervon;614;8;622
35;004;Val-Couesnon;35;303;Saint-Ouen-la-Rouërie;825;11;836
35;308;Mesnil-Roc'h;35;308;Saint-Pierre-de-Plesguen;3014;55;3069
35;191;Les Portes du Coglais;35;323;La Selle-en-Coglès;574;10;584
35;004;Val-Couesnon;35;341;Tremblay;1488;40;1528
35;308;Mesnil-Roc'h;35;344;Tressé;423;9;432
35;282;Rives-du-Couesnon;35;348;Vendel;403;3;406
36;070;Éguzon-Chantôme;36;039;Chantôme;80;3;83
36;244;Villentrois-Faverolles-en-Berry;36;072;Faverolles-en-Berry;296;3;299
36;229;Val-Fouzon;36;151;Parpeçay;216;3;219
36;229;Val-Fouzon;36;183;Sainte-Cécile;86;1;87
36;093;Levroux;36;201;Saint-Martin-de-Lamps;148;0;148
36;229;Val-Fouzon;36;229;Varennes-sur-Fouzon;649;12;661
36;244;Villentrois-Faverolles-en-Berry;36;244;Villentrois;577;3;580
36;202;Saint-Maur;36;245;Villers-les-Ormes;458;10;468
37;021;Beaumont-Louestault;37;021;Beaumont-la-Ronce;1378;24;1402
37;123;Langeais;37;102;Les Essards;144;1;145
37;232;Coteaux-sur-Loire;37;120;Ingrandes-de-Touraine;538;10;548
37;021;Beaumont-Louestault;37;135;Louestault;364;7;371
37;254;Tauxigny-Saint-Bauld;37;209;Saint-Bauld;176;3;179
37;232;Coteaux-sur-Loire;37;227;Saint-Michel-sur-Loire;703;16;719
37;232;Coteaux-sur-Loire;37;232;Saint-Patrice;646;13;659
38;001;Les Abrets en Dauphiné;38;001;Les Abrets;3541;47;3588
38;297;Arandon-Passins;38;014;Arandon;695;10;705
38;479;Porte-des-Bonnevaux;38;016;Arzay;230;3;233
38;225;Autrans-Méaudre en Vercors;38;021;Autrans;1578;42;1620
38;022;Les Avenières Veyrins-Thuellin;38;022;Les Avenières;5651;107;5758
38;284;Ornacieux-Balbins;38;025;Balbins;449;11;460
38;001;Les Abrets en Dauphiné;38;028;La Bâtie-Divisin;942;19;961
38;073;Chantepérier;38;073;Chantelouve;64;2;66
38;479;Porte-des-Bonnevaux;38;121;Commelle;945;27;972
38;456;Châtel-en-Trièves;38;125;Cordéac;223;4;227
38;359;Saint Antoine l'Abbaye;38;145;Dionay;119;2;121
38;163;Le Haut-Bréda;38;163;La Ferrière;231;7;238
38;001;Les Abrets en Dauphiné;38;165;Fitilieu;1956;39;1995
38;225;Autrans-Méaudre en Vercors;38;225;Méaudre;1490;62;1552
38;253;Les Deux Alpes;38;253;Mont-de-Lans;1112;22;1134
38;439;Crêts en Belledonne;38;262;Morêtel-de-Mailles;481;5;486
38;479;Porte-des-Bonnevaux;38;274;Nantoin;503;10;513
38;284;Ornacieux-Balbins;38;284;Ornacieux;410;11;421
38;292;Villages du Lac de Paladru;38;292;Paladru;1255;31;1286
38;297;Arandon-Passins;38;297;Passins;1178;33;1211
38;073;Chantepérier;38;302;Le Périer;136;1;137
38;292;Villages du Lac de Paladru;38;305;Le Pin;1271;27;1298
38;163;Le Haut-Bréda;38;306;Pinsot;180;2;182
38;395;Plateau-des-Petites-Roches;38;367;Saint-Bernard;681;24;705
38;395;Plateau-des-Petites-Roches;38;395;Saint-Hilaire;1268;38;1306
38;395;Plateau-des-Petites-Roches;38;435;Saint-Pancrasse;448;11;459
38;456;Châtel-en-Trièves;38;456;Saint-Sébastien;268;6;274
38;479;Porte-des-Bonnevaux;38;479;Semons;368;16;384
38;253;Les Deux Alpes;38;534;Vénosc;830;15;845
38;022;Les Avenières Veyrins-Thuellin;38;541;Veyrins-Thuellin;2126;54;2180
39;385;Neublans-Abergement;39;005;Abergement-Saint-Jean;84;0;84
25;527;Saint-Vit;39;012;Antorpe;802;14;816
39;018;Aromas;39;018;Aromas;550;7;557
39;022;Asnans-Beauvoisin;39;044;Beauvoisin;206;7;213
39;576;Val-Sonnette;39;064;Bonnaud;59;0;59
39;199;Domblans;39;075;Bréry;213;7;220
39;258;Grande-Rivière Château;39;115;Château-des-Prés;199;1;200
39;491;Coteaux du Lizon;39;186;Cuttura;307;10;317
39;190;Dampierre;39;190;Dampierre;1185;28;1213
39;273;Montlainsia;39;195;Dessia;75;2;77
39;329;Mièges;39;213;Esserval-Combe;24;0;24
39;577;Vincent-Froideville;39;243;Froideville;64;2;66
39;198;Dole;39;256;Goux;307;11;318
39;258;Grande-Rivière Château;39;258;Grande-Rivière;433;13;446
39;576;Val-Sonnette;39;264;Grusse;179;7;186
39;273;Montlainsia;39;273;Lains;64;1;65
39;286;Lavans-lès-Saint-Claude;39;286;Lavans-lès-Saint-Claude;1772;82;1854
39;368;Hauts de Bienne;39;294;Lézat;183;7;190
39;329;Mièges;39;329;Mièges;118;2;120
39;329;Mièges;39;340;Molpré;28;0;28
39;273;Montlainsia;39;347;Montagna-le-Templier;93;1;94
39;368;Hauts de Bienne;39;368;Morez;4737;256;4993
39;010;Andelot-Morval;39;369;Morval;28;0;28
39;368;Hauts de Bienne;39;371;La Mouille;306;7;313
39;205;Éclans-Nenon;39;383;Nenon;117;5;122
39;190;Dampierre;39;414;Le Petit-Mercey;130;1;131
39;130;Nanchez;39;417;Les Piards;170;4;174
39;286;Lavans-lès-Saint-Claude;39;438;Ponthoux;68;3;71
39;286;Lavans-lès-Saint-Claude;39;440;Pratz;487;21;508
39;130;Nanchez;39;442;Prénovel;258;16;274
39;017;Arlay;39;482;Saint-Germain-lès-Arlay;423;19;442
39;491;Coteaux du Lizon;39;491;Saint-Lupicin;1884;81;1965
39;583;Vosbles-Valfin;39;542;Valfin-sur-Valouse;73;4;77
39;576;Val-Sonnette;39;549;Vercia;300;9;309
39;130;Nanchez;39;562;Villard-sur-Bienne;172;15;187
39;018;Aromas;39;566;Villeneuve-lès-Charnod;84;0;84
39;576;Val-Sonnette;39;576;Vincelles;398;10;408
39;086;Cernon;39;578;Viremont;28;1;29
40;197;Morcenx-la-Nouvelle;40;009;Arjuzanx;208;5;213
40;243;Rion-des-Landes;40;048;Boos;478;5;483
40;197;Morcenx-la-Nouvelle;40;107;Garrosse;304;3;307
40;243;Rion-des-Landes;40;243;Rion-des-Landes;2587;36;2623
40;197;Morcenx-la-Nouvelle;40;302;Sindères;178;6;184
41;248;Couëtron-au-Perche;41;005;Arville;92;0;92
41;171;Oucques La Nouvelle;41;011;Baigneaux;60;1;61
41;171;Oucques La Nouvelle;41;015;Beauvilliers;55;1;56
41;273;Vievy-le-Rayé;41;021;La Bosse;125;3;128
41;151;Montrichard Val de Cher;41;023;Bourré;604;11;615
41;142;Valencisse;41;033;Chambon-sur-Cisse;679;51;730
41;055;Valloire-sur-Cisse;41;055;Chouzy-sur-Cisse;1986;40;2026
41;173;Beauce la Romaine;41;056;La Colombe;173;4;177
41;059;Le Controis-en-Sologne;41;059;Contres;3566;72;3638
41;055;Valloire-sur-Cisse;41;064;Coulanges;306;13;319
41;070;Vallée-de-Ronsard;41;070;Couture-sur-Loir;413;10;423
41;273;Vievy-le-Rayé;41;076;Écoman;130;2;132
41;059;Le Controis-en-Sologne;41;082;Feings;704;12;716
41;059;Le Controis-en-Sologne;41;092;Fougères-sur-Bièvre;775;31;806
41;173;Beauce la Romaine;41;133;Membrolles;276;2;278
41;142;Valencisse;41;142;Molineuf;730;19;749
41;151;Montrichard Val de Cher;41;151;Montrichard;3071;30;3101
41;248;Couëtron-au-Perche;41;165;Oigny;88;5;93
41;167;Veuzain-sur-Loire;41;167;Onzain;3179;84;3263
41;142;Valencisse;41;169;Orchaise;922;25;947
41;059;Le Controis-en-Sologne;41;170;Ouchamps;720;26;746
41;171;Oucques La Nouvelle;41;171;Oucques;1493;25;1518
41;173;Beauce la Romaine;41;173;Ouzouer-le-Marché;2028;41;2069
41;173;Beauce la Romaine;41;183;Prénouvellon;264;8;272
41;248;Couëtron-au-Perche;41;197;Saint-Agil;273;2;275
41;248;Couëtron-au-Perche;41;202;Saint-Avit;94;3;97
41;171;Oucques La Nouvelle;41;210;Sainte-Gemmes;94;2;96
41;149;Montoire-sur-le-Loir;41;227;Saint-Quentin-lès-Troo;222;5;227
41;055;Valloire-sur-Cisse;41;240;Seillac;109;1;110
41;173;Beauce la Romaine;41;244;Semerville;88;0;88
41;248;Couëtron-au-Perche;41;248;Souday;484;12;496
41;059;Le Controis-en-Sologne;41;257;Thenay;898;13;911
41;070;Vallée-de-Ronsard;41;263;Tréhet;105;1;106
41;173;Beauce la Romaine;41;264;Tripleville;171;1;172
41;173;Beauce la Romaine;41;270;Verdes;436;4;440
41;167;Veuzain-sur-Loire;41;272;Veuves;222;3;225
42;268;Vézelin-sur-Loire;42;004;Amions;304;5;309
42;039;Chalmazel-Jeansagnière;42;039;Chalmazel;357;2;359
42;225;Genilac;42;080;La Cula;972;14;986
42;268;Vézelin-sur-Loire;42;082;Dancé;175;6;181
42;039;Chalmazel-Jeansagnière;42;114;Jeansagnière;96;3;99
42;218;Saint-Étienne;42;190;Rochetaillée;685;8;693
42;245;Vêtre-sur-Anzon;42;245;Saint-Julien-la-Vêtre;367;6;373
42;279;Saint-Just-Saint-Rambert;42;250;Saint-Just-sur-Loire;7012;115;7127
42;268;Vézelin-sur-Loire;42;268;Saint-Paul-de-Vézelin;324;4;328
42;245;Vêtre-sur-Anzon;42;291;Saint-Thurin;211;7;218
43;221;Saint-Privat-d'Allier;43;176;Saint-Didier-d'Allier;49;0;49
43;090;Esplantas-Vazeilles;43;255;Vazeilles-près-Saugues;35;1;36
44;163;Vair-sur-Loire;44;004;Anetz;2126;55;2181
44;005;Chaumes-en-Retz;44;005;Arthon-en-Retz;4350;69;4419
44;029;Divatte-sur-Loire;44;008;Barbechat;1331;21;1352
44;213;Loireauxence;44;011;Belligné;1812;31;1843
44;180;Vallons-de-l'Erdre;44;017;Bonnœuvre;552;15;567
44;021;Villeneuve-en-Retz;44;021;Bourgneuf-en-Retz;3743;59;3802
44;029;Divatte-sur-Loire;44;029;La Chapelle-Basse-Mer;5711;99;5810
44;213;Loireauxence;44;034;La Chapelle-Saint-Sauveur;821;9;830
44;005;Chaumes-en-Retz;44;040;Chéméré;2699;40;2739
44;021;Villeneuve-en-Retz;44;059;Fresnay-en-Retz;1270;28;1298
44;087;Machecoul-Saint-Même;44;087;Machecoul;6397;208;6605
44;180;Vallons-de-l'Erdre;44;093;Maumusson;1063;26;1089
44;213;Loireauxence;44;147;La Rouxière;1175;11;1186
44;163;Vair-sur-Loire;44;163;Saint-Herblon;2681;51;2732
44;180;Vallons-de-l'Erdre;44;180;Saint-Mars-la-Jaille;2370;40;2410
44;087;Machecoul-Saint-Même;44;181;Saint-Même-le-Tenu;1229;25;1254
44;180;Vallons-de-l'Erdre;44;191;Saint-Sulpice-des-Landes;670;13;683
44;213;Loireauxence;44;213;Varades;3725;74;3799
44;180;Vallons-de-l'Erdre;44;219;Vritz;739;8;747
44;180;Vallons-de-l'Erdre;44;225;Freigné;1091;20;1111
45;240;Outarville;45;003;Allainville-en-Beauce;143;6;149
45;155;Gien;45;007;Arrabloy;544;17;561
45;253;Pithiviers-le-Vieil;45;048;Bouzonville-en-Beauce;289;7;296
45;191;Le Malesherbois;45;057;Labrosse;95;1;96
45;035;Boiscommun;45;090;Chemault;286;10;296
45;191;Le Malesherbois;45;106;Coudray;385;16;401
45;240;Outarville;45;140;Faronville;131;0;131
45;160;Greneville-en-Beauce;45;163;Guignonville;281;4;285
45;025;Bazoches-les-Gallerandes;45;172;Izy;309;3;312
45;191;Le Malesherbois;45;190;Mainvilliers;261;3;264
45;191;Le Malesherbois;45;191;Malesherbes;5987;117;6104
45;191;Le Malesherbois;45;192;Manchecourt;751;12;763
45;191;Le Malesherbois;45;221;Nangeville;112;1;113
45;191;Le Malesherbois;45;236;Orveau-Bellesauve;413;11;424
45;240;Outarville;45;295;Saint-Péravy-Épreux;176;5;181
45;162;Guigneville;45;304;Sébouville;208;7;215
45;240;Outarville;45;318;Teillay-le-Gaudin;145;4;149
45;118;Crottes-en-Pithiverais;45;319;Teillay-Saint-Benoît;76;0;76
45;348;Yèvre-la-Ville;45;349;Yèvre-le-Châtel;209;6;215
46;263;Barguelonne-en-Quercy;46;014;Bagat-en-Quercy;191;4;195
46;138;Cœur de Causse;46;019;Beaumat;72;0;72
46;033;Porte-du-Quercy;46;033;Le Boulvé;162;4;166
46;311;Sousceyrac-en-Quercy;46;048;Calviac;149;0;149
46;063;Castelnau Montratier-Sainte Alauzie;46;063;Castelnau-Montratier;1730;37;1767
46;232;Le Vignon-en-Quercy;46;067;Cazillac;419;11;430
46;311;Sousceyrac-en-Quercy;46;071;Comiac;212;4;216
46;156;Bellefont-La Rauze;46;077;Cours;295;5;300
46;083;Cressensac-Sarrazac;46;083;Cressensac;613;6;619
46;033;Porte-du-Quercy;46;099;Fargues;164;3;167
46;103;Saint-Paul-Flaugnac;46;103;Flaugnac;408;11;419
46;138;Cœur de Causse;46;110;Fontanes-du-Causse;62;1;63
46;138;Cœur de Causse;46;138;Labastide-Murat;620;15;635
46;311;Sousceyrac-en-Quercy;46;141;Lacam-d'Ourcet;105;5;110
46;311;Sousceyrac-en-Quercy;46;150;Lamativie;55;1;56
46;156;Bellefont-La Rauze;46;156;Laroque-des-Arcs;465;11;476
46;262;Lendou-en-Quercy;46;158;Lascabanes;216;4;220
46;232;Le Vignon-en-Quercy;46;232;Les Quatre-Routes-du-Lot;566;13;579
46;063;Castelnau Montratier-Sainte Alauzie;46;248;Sainte-Alauzie;106;1;107
46;252;Les Pechs du Vers;46;252;Saint-Cernin;205;5;210
46;262;Lendou-en-Quercy;46;262;Saint-Cyprien;245;5;250
46;263;Barguelonne-en-Quercy;46;263;Saint-Daunès;222;6;228
46;268;Saint Géry-Vers;46;268;Saint-Géry;445;13;458
46;262;Lendou-en-Quercy;46;274;Saint-Laurent-Lolmie;168;4;172
46;252;Les Pechs du Vers;46;275;Saint-Martin-de-Vers;109;3;112
46;033;Porte-du-Quercy;46;278;Saint-Matré;122;3;125
46;263;Barguelonne-en-Quercy;46;285;Saint-Pantaléon;284;6;290
46;103;Saint-Paul-Flaugnac;46;287;Saint-Paul-de-Loubressac;586;15;601
46;138;Cœur de Causse;46;291;Saint-Sauveur-la-Vallée;51;0;51
46;083;Cressensac-Sarrazac;46;298;Sarrazac;512;9;521
46;033;Porte-du-Quercy;46;300;Saux;112;2;114
46;311;Sousceyrac-en-Quercy;46;311;Sousceyrac;813;9;822
46;138;Cœur de Causse;46;325;Vaillac;95;2;97
46;156;Bellefont-La Rauze;46;327;Valroufié;453;14;467
46;268;Saint Géry-Vers;46;331;Vers;462;7;469
47;302;Sos;47;116;Gueyze;137;3;140
47;221;Réaup-Lisse;47;149;Lisse;230;7;237
47;302;Sos;47;166;Meylan;51;0;51
47;206;Pinel-Hauterive;47;268;Saint-Pierre-de-Caubel;189;1;190
47;134;Lannes;47;322;Villeneuve-de-Mézin;73;0;73
48;009;Peyre en Aubrac;48;009;Aumont-Aubrac;1026;27;1053
48;034;La Canourgue;48;011;Auxillac;332;6;338
48;027;Mont Lozère et Goulet;48;014;Bagnols-les-Bains;246;4;250
48;027;Mont Lozère et Goulet;48;023;Belvezet;79;0;79
48;027;Mont Lozère et Goulet;48;027;Le Bleymard;380;25;405
48;034;La Canourgue;48;035;La Capelle;97;6;103
48;038;Bel-Air-Val-d'Ance;48;038;Chambon-le-Château;292;4;296
48;027;Mont Lozère et Goulet;48;040;Chasseradès;142;1;143
48;009;Peyre en Aubrac;48;047;La Chaze-de-Peyre;324;5;329
48;099;Bourgs sur Colagne;48;049;Chirac;1143;18;1161
48;127;Monts-de-Randon;48;057;Estables;154;2;156
48;009;Peyre en Aubrac;48;060;Fau-de-Peyre;176;1;177
48;105;Naussac-Fontanes;48;062;Fontanes;164;7;171
48;116;Pont de Montvert - Sud Mont Lozère;48;066;Fraissinet-de-Lozère;191;8;199
48;009;Peyre en Aubrac;48;076;Javols;322;54;376
48;126;Lachamp-Ribennes;48;078;Lachamp;184;5;189
48;139;Saint Bonnet-Laval;48;084;Laval-Atger;148;2;150
48;087;Prinsuéjols-Malbouzon;48;087;Malbouzon;120;4;124
48;027;Mont Lozère et Goulet;48;093;Mas-d'Orcières;103;0;103
48;094;Massegros Causses Gorges;48;094;Le Massegros;404;12;416
48;099;Bourgs sur Colagne;48;099;Le Monastier-Pin-Moriès;948;28;976
48;146;Gorges du Tarn Causses;48;101;Montbrun;80;3;83
48;034;La Canourgue;48;102;Montjézieu;124;6;130
48;105;Naussac-Fontanes;48;105;Naussac;209;8;217
48;116;Pont de Montvert - Sud Mont Lozère;48;116;Le Pont-de-Montvert;306;8;314
48;087;Prinsuéjols-Malbouzon;48;120;Prinsuéjols;144;6;150
48;146;Gorges du Tarn Causses;48;122;Quézac;324;8;332
48;094;Massegros Causses Gorges;48;125;Le Recoux;130;7;137
48;126;Lachamp-Ribennes;48;126;Ribennes;179;6;185
48;127;Monts-de-Randon;48;127;Rieutort-de-Randon;761;17;778
48;127;Monts-de-Randon;48;133;Saint-Amans;177;3;180
48;152;Ventalon en Cévennes;48;134;Saint-Andéol-de-Clerguemort;92;2;94
48;139;Saint Bonnet-Laval;48;139;Saint-Bonnet-de-Montauroux;105;0;105
48;009;Peyre en Aubrac;48;142;Sainte-Colombe-de-Peyre;199;4;203
48;146;Gorges du Tarn Causses;48;146;Sainte-Enimie;501;22;523
48;152;Ventalon en Cévennes;48;152;Saint-Frézal-de-Ventalon;171;3;174
48;094;Massegros Causses Gorges;48;154;Saint-Georges-de-Lévéjac;264;5;269
48;166;Cans et Cévennes;48;162;Saint-Julien-d'Arpaon;94;1;95
48;027;Mont Lozère et Goulet;48;164;Saint-Julien-du-Tournel;112;0;112
48;166;Cans et Cévennes;48;166;Saint-Laurent-de-Trèves;196;11;207
48;116;Pont de Montvert - Sud Mont Lozère;48;172;Saint-Maurice-de-Ventalon;57;2;59
48;094;Massegros Causses Gorges;48;180;Saint-Rome-de-Dolan;66;3;69
48;009;Peyre en Aubrac;48;183;Saint-Sauveur-de-Peyre;248;7;255
48;038;Bel-Air-Val-d'Ance;48;184;Saint-Symphorien;253;3;256
48;127;Monts-de-Randon;48;189;Servières;137;3;140
48;094;Massegros Causses Gorges;48;195;Les Vignes;80;1;81
48;039;Chanac;48;196;Le Villard;84;3;87
48;127;Monts-de-Randon;48;197;La Villedieu;35;0;35
49;050;Brissac Loire Aubance;49;001;Les Alleuds;948;24;972
49;003;Tuffalun;49;003;Ambillou-Château;928;19;947
49;307;Loire-Authion;49;004;Andard;2870;100;2970
49;176;Le Lion-d'Angers;49;005;Andigné;432;6;438
49;023;Beaupréau-en-Mauges;49;006;Andrezé;1940;58;1998
49;228;Noyant-Villages;49;013;Auverse;448;10;458
49;331;Segré-en-Anjou Bleu;49;014;Aviré;488;23;511
49;328;Saumur;49;016;Bagneux;4289;157;4446
49;018;Baugé-en-Anjou;49;018;Baugé;3698;77;3775
49;307;Loire-Authion;49;019;Bauné;1749;61;1810
49;021;Beaufort-en-Anjou;49;021;Beaufort-en-Vallée;6628;96;6724
49;023;Beaupréau-en-Mauges;49;023;Beaupréau;7463;222;7685
49;244;Mauges-sur-Loire;49;024;Beausse;372;10;382
49;163;Jarzé Villages;49;025;Beauvau;296;3;299
49;029;Blaison-Saint-Sulpice;49;029;Blaison-Gohier;1100;24;1124
49;018;Baugé-en-Anjou;49;031;Bocé;635;13;648
49;307;Loire-Authion;49;032;La Bohalle;1249;43;1292
49;218;Montrevault-sur-Èvre;49;033;La Boissière-sur-Èvre;436;8;444
49;244;Mauges-sur-Loire;49;034;Botz-en-Mauges;785;21;806
49;331;Segré-en-Anjou Bleu;49;037;Le Bourg-d'Iré;826;38;864
49;244;Mauges-sur-Loire;49;039;Bourgneuf-en-Mauges;658;17;675
49;069;Orée d'Anjou;49;040;Bouzillé;1502;28;1530
49;307;Loire-Authion;49;042;Brain-sur-l'Authion;3418;119;3537
49;367;Erdre-en-Anjou;49;043;Brain-sur-Longuenée;945;14;959
49;228;Noyant-Villages;49;044;Breil;238;3;241
49;060;Bellevigne-les-Châteaux;49;046;Brézé;1224;29;1253
49;125;Doué-en-Anjou;49;047;Brigné;462;10;472
49;138;Les Bois d'Anjou;49;049;Brion;1173;19;1192
49;050;Brissac Loire Aubance;49;050;Brissac-Quincé;3178;80;3258
49;080;Les Hauts-d'Anjou;49;051;Brissarthe;616;7;623
49;228;Noyant-Villages;49;052;Broc;301;4;305
49;373;Lys-Haut-Layon;49;059;Les Cerqueux-sous-Passavant;494;9;503
49;060;Bellevigne-les-Châteaux;49;060;Chacé;1400;33;1433
49;228;Noyant-Villages;49;062;Chalonnes-sous-le-Lude;131;4;135
49;080;Les Hauts-d'Anjou;49;065;Champigné;2277;73;2350
49;345;Bellevigne-en-Layon;49;066;Champ-sur-Layon;958;18;976
49;067;Chenillé-Champteussé;49;067;Champteussé-sur-Baconne;206;4;210
49;069;Orée d'Anjou;49;069;Champtoceaux;2648;49;2697
49;092;Chemillé-en-Anjou;49;071;Chanzeaux;1128;33;1161
49;023;Beaupréau-en-Mauges;49;072;La Chapelle-du-Genêt;1165;35;1200
49;248;Ombrée d'Anjou;49;073;La Chapelle-Hullin;131;3;134
49;092;Chemillé-en-Anjou;49;074;La Chapelle-Rousselin;810;24;834
49;244;Mauges-sur-Loire;49;075;La Chapelle-Saint-Florent;1423;37;1460
49;331;Segré-en-Anjou Bleu;49;077;La Chapelle-sur-Oudon;683;32;715
49;050;Brissac Loire Aubance;49;078;Charcé-Saint-Ellier-sur-Aubance;768;19;787
49;018;Baugé-en-Anjou;49;079;Chartrené;52;1;53
49;080;Les Hauts-d'Anjou;49;080;Châteauneuf-sur-Sarthe;3071;27;3098
49;331;Segré-en-Anjou Bleu;49;081;Châtelais;670;31;701
49;218;Montrevault-sur-Èvre;49;083;Chaudron-en-Mauges;1431;28;1459
49;163;Jarzé Villages;49;084;Chaumont-d'Anjou;289;5;294
49;218;Montrevault-sur-Èvre;49;085;La Chaussaire;810;16;826
49;086;Terranjou;49;086;Chavagnes;1291;27;1318
49;228;Noyant-Villages;49;087;Chavaignes;93;1;94
49;248;Ombrée d'Anjou;49;088;Chazé-Henry;768;7;775
49;050;Brissac Loire Aubance;49;091;Chemellier;787;20;807
49;092;Chemillé-en-Anjou;49;092;Chemillé;7384;218;7602
49;220;Morannes sur Sarthe-Daumeray;49;093;Chemiré-sur-Sarthe;265;5;270
49;261;Gennes-Val-de-Loire;49;094;Chênehutte-Trèves-Cunault;974;25;999
49;067;Chenillé-Champteussé;49;095;Chenillé-Changé;136;2;138
49;080;Les Hauts-d'Anjou;49;096;Cherré;557;7;564
49;018;Baugé-en-Anjou;49;097;Cheviré-le-Rouge;840;17;857
49;228;Noyant-Villages;49;098;Chigné;300;7;307
49;018;Baugé-en-Anjou;49;101;Clefs;1000;21;1021
49;248;Ombrée d'Anjou;49;103;Combrée;2749;53;2802
49;125;Doué-en-Anjou;49;104;Concourson-sur-Layon;573;13;586
49;080;Les Hauts-d'Anjou;49;105;Contigné;774;10;784
49;307;Loire-Authion;49;106;Corné;3199;111;3310
49;183;Val d'Erdre-Auxence;49;108;La Cornuaille;954;18;972
49;092;Chemillé-en-Anjou;49;111;Cossé-d'Anjou;398;12;410
49;050;Brissac Loire Aubance;49;115;Coutures;517;13;530
49;018;Baugé-en-Anjou;49;116;Cuon;571;12;583
49;307;Loire-Authion;49;117;La Daguenière;1225;42;1267
49;328;Saumur;49;118;Dampierre-sur-Loire;305;11;316
49;220;Morannes sur Sarthe-Daumeray;49;119;Daumeray;1502;17;1519
49;228;Noyant-Villages;49;122;Dénezé-sous-le-Lude;259;4;263
49;125;Doué-en-Anjou;49;125;Doué-la-Fontaine;7752;172;7924
49;069;Orée d'Anjou;49;126;Drain;2115;40;2155
49;018;Baugé-en-Anjou;49;128;Échemiré;590;12;602
49;345;Bellevigne-en-Layon;49;133;Faveraye-Mâchelles;652;11;663
49;345;Bellevigne-en-Layon;49;134;Faye-d'Anjou;1406;31;1437
49;331;Segré-en-Anjou Bleu;49;136;La Ferrière-de-Flée;346;16;362
49;218;Montrevault-sur-Èvre;49;137;Le Fief-Sauvin;1703;33;1736
49;138;Les Bois d'Anjou;49;138;Fontaine-Guérin;945;27;972
49;194;Mazé-Milon;49;139;Fontaine-Milon;592;14;606
49;125;Doué-en-Anjou;49;141;Forges;348;8;356
49;373;Lys-Haut-Layon;49;142;La Fosse-de-Tigné;236;2;238
49;018;Baugé-en-Anjou;49;143;Fougeré;806;17;823
49;218;Montrevault-sur-Èvre;49;145;Le Fuilet;1870;36;1906
49;021;Beaufort-en-Anjou;49;147;Gée;468;50;518
49;367;Erdre-en-Anjou;49;148;Gené;496;8;504
49;261;Gennes-Val-de-Loire;49;149;Gennes;2366;40;2406
49;228;Noyant-Villages;49;150;Genneteil;305;5;310
49;023;Beaupréau-en-Mauges;49;151;Gesté;2805;84;2889
49;092;Chemillé-en-Anjou;49;153;Valanjou;2178;64;2242
49;261;Gennes-Val-de-Loire;49;154;Grézillé;616;11;627
49;248;Ombrée d'Anjou;49;156;Grugé-l'Hôpital;303;3;306
49;018;Baugé-en-Anjou;49;157;Le Guédeniau;384;8;392
49;331;Segré-en-Anjou Bleu;49;158;L'Hôtellerie-de-Flée;551;26;577
49;174;Huillé-Lézigné;49;159;Huillé;557;10;567
49;023;Beaupréau-en-Mauges;49;162;Jallais;3479;104;3583
49;163;Jarzé Villages;49;163;Jarzé;1851;15;1866
49;023;Beaupréau-en-Mauges;49;165;La Jubaudière;1233;37;1270
49;167;Les Garennes sur Loire;49;167;Juigné-sur-Loire;2762;51;2813
49;180;Longué-Jumelles;49;168;Jumelles;1113;18;1131
49;092;Chemillé-en-Anjou;49;169;La Jumellière;1366;40;1406
49;069;Orée d'Anjou;49;172;Landemont;1911;36;1947
49;228;Noyant-Villages;49;173;Lasse;270;5;275
49;174;Huillé-Lézigné;49;174;Lézigné;761;12;773
49;228;Noyant-Villages;49;175;Linières-Bouton;90;3;93
49;069;Orée d'Anjou;49;177;Liré;2500;47;2547
49;301;Sèvremoine;49;179;Le Longeron;2123;48;2171
49;003;Tuffalun;49;181;Louerre;464;12;476
49;183;Val d'Erdre-Auxence;49;183;Le Louroux-Béconnais;3271;53;3324
49;331;Segré-en-Anjou Bleu;49;184;Louvaines;442;20;462
49;163;Jarzé Villages;49;185;Lué-en-Baugeois;330;8;338
49;050;Brissac Loire Aubance;49;186;Luigné;278;7;285
49;331;Segré-en-Anjou Bleu;49;187;Marans;561;26;587
49;080;Les Hauts-d'Anjou;49;189;Marigné;703;16;719
49;244;Mauges-sur-Loire;49;190;Le Marillais;1117;29;1146
49;086;Terranjou;49;191;Martigné-Briand;1894;39;1933
49;194;Mazé-Milon;49;194;Mazé;5268;78;5346
49;200;Longuenée-en-Anjou;49;196;La Meignanne;2272;103;2375
49;228;Noyant-Villages;49;197;Meigné-le-Vicomte;302;4;306
49;125;Doué-en-Anjou;49;198;Meigné;367;8;375
49;092;Chemillé-en-Anjou;49;199;Melay;1575;46;1621
49;200;Longuenée-en-Anjou;49;200;La Membrolle-sur-Longuenée;2041;27;2068
49;228;Noyant-Villages;49;202;Méon;234;4;238
49;244;Mauges-sur-Loire;49;204;Le Mesnil-en-Vallée;1425;38;1463
49;301;Sèvremoine;49;206;Montfaucon-Montigné;2345;53;2398
49;125;Doué-en-Anjou;49;207;Montfort;112;2;114
49;331;Segré-en-Anjou Bleu;49;208;Montguillon;217;10;227
49;244;Mauges-sur-Loire;49;212;Montjean-sur-Loire;3160;83;3243
49;018;Baugé-en-Anjou;49;213;Montpollin;260;5;265
49;218;Montrevault-sur-Èvre;49;218;Montrevault;1162;22;1184
49;092;Chemillé-en-Anjou;49;225;Neuvy-en-Mauges;832;25;857
49;248;Ombrée d'Anjou;49;226;Noëllet;478;7;485
49;086;Terranjou;49;227;Notre-Dame-d'Allençon;765;7;772
49;228;Noyant-Villages;49;228;Noyant;1764;55;1819
49;331;Segré-en-Anjou Bleu;49;229;Noyant-la-Gravoyère;1900;88;1988
49;003;Tuffalun;49;230;Noyant-la-Plaine;351;6;357
49;373;Lys-Haut-Layon;49;232;Nueil-sur-Layon;1310;19;1329
49;331;Segré-en-Anjou Bleu;49;233;Nyoiseau;1191;55;1246
49;228;Noyant-Villages;49;234;Parçay-les-Pins;794;8;802
49;323;Verrières-en-Anjou;49;238;Pellouailles-les-Vignes;2560;41;2601
49;023;Beaupréau-en-Mauges;49;239;Le Pin-en-Mauges;1388;42;1430
49;200;Longuenée-en-Anjou;49;242;Le Plessis-Macé;1300;27;1327
49;023;Beaupréau-en-Mauges;49;243;La Poitevinière;1092;33;1125
49;244;Mauges-sur-Loire;49;244;La Pommeraye;3983;105;4088
49;018;Baugé-en-Anjou;49;245;Pontigné;226;5;231
49;248;Ombrée d'Anjou;49;248;Pouancé;3166;116;3282
49;367;Erdre-en-Anjou;49;249;La Pouëze;2001;27;2028
49;248;Ombrée d'Anjou;49;250;La Prévière;232;5;237
49;200;Longuenée-en-Anjou;49;251;Pruillé;721;15;736
49;218;Montrevault-sur-Èvre;49;252;Le Puiset-Doré;1170;23;1193
49;080;Les Hauts-d'Anjou;49;254;Querré;366;4;370
49;345;Bellevigne-en-Layon;49;256;Rablay-sur-Layon;788;17;805
49;301;Sèvremoine;49;258;La Renaudière;1045;24;1069
49;261;Gennes-Val-de-Loire;49;261;Les Rosiers-sur-Loire;2328;44;2372
49;301;Sèvremoine;49;263;Roussay;1224;28;1252
49;301;Sèvremoine;49;264;Saint-André-de-la-Marche;2949;67;3016
49;292;Val-du-Layon;49;265;Saint-Aubin-de-Luigné;1272;23;1295
49;092;Chemillé-en-Anjou;49;268;Sainte-Christine;766;23;789
49;069;Orée d'Anjou;49;270;Saint-Christophe-la-Couperie;791;15;806
49;301;Sèvremoine;49;273;Saint-Crespin-sur-Moine;1581;36;1617
49;060;Bellevigne-les-Châteaux;49;274;Saint-Cyr-en-Bourg;847;17;864
49;244;Mauges-sur-Loire;49;276;Saint-Florent-le-Vieil;2872;76;2948
49;331;Segré-en-Anjou Bleu;49;277;Sainte-Gemmes-d'Andigné;1422;66;1488
49;261;Gennes-Val-de-Loire;49;279;Saint-Georges-des-Sept-Voies;659;9;668
49;138;Les Bois d'Anjou;49;280;Saint-Georges-du-Bois;456;6;462
49;092;Chemillé-en-Anjou;49;281;Saint-Georges-des-Gardes;1603;47;1650
49;125;Doué-en-Anjou;49;282;Saint-Georges-sur-Layon;745;16;761
49;301;Sèvremoine;49;285;Saint-Germain-sur-Moine;3009;68;3077
49;373;Lys-Haut-Layon;49;286;Saint-Hilaire-du-Bois;1353;43;1396
49;328;Saumur;49;287;Saint-Hilaire-Saint-Florent;4001;147;4148
49;298;Saint-Léger-de-Linières;49;289;Saint-Jean-de-Linières;1771;35;1806
49;167;Les Garennes sur Loire;49;290;Saint-Jean-des-Mauvrets;1852;58;1910
49;292;Val-du-Layon;49;292;Saint-Lambert-du-Lattay;2183;25;2208
49;328;Saumur;49;293;Saint-Lambert-des-Levées;3244;119;3363
49;244;Mauges-sur-Loire;49;295;Saint-Laurent-de-la-Plaine;1566;41;1607
49;069;Orée d'Anjou;49;296;Saint-Laurent-des-Autels;2202;41;2243
49;244;Mauges-sur-Loire;49;297;Saint-Laurent-du-Mottay;722;19;741
49;298;Saint-Léger-de-Linières;49;298;Saint-Léger-des-Bois;1978;30;2008
49;092;Chemillé-en-Anjou;49;300;Saint-Lézin;744;22;766
49;301;Sèvremoine;49;301;Saint-Macaire-en-Mauges;7103;158;7261
49;018;Baugé-en-Anjou;49;303;Saint-Martin-d'Arcé;806;17;823
49;261;Gennes-Val-de-Loire;49;304;Saint-Martin-de-la-Place;1129;19;1148
49;331;Segré-en-Anjou Bleu;49;305;Saint-Martin-du-Bois;1015;47;1062
49;307;Loire-Authion;49;307;Saint-Mathurin-sur-Loire;2583;89;2672
49;248;Ombrée d'Anjou;49;309;Saint-Michel-et-Chanveaux;387;7;394
49;023;Beaupréau-en-Mauges;49;312;Saint-Philbert-en-Mauges;394;12;406
49;218;Montrevault-sur-Èvre;49;313;Saint-Pierre-Montlimart;3438;67;3505
49;218;Montrevault-sur-Èvre;49;314;Saint-Quentin-en-Mauges;1055;21;1076
49;018;Baugé-en-Anjou;49;315;Saint-Quentin-lès-Beaurepaire;313;6;319
49;218;Montrevault-sur-Èvre;49;316;Saint-Rémy-en-Mauges;1387;27;1414
49;050;Brissac Loire Aubance;49;317;Saint-Rémy-la-Varenne;923;23;946
49;050;Brissac Loire Aubance;49;318;Saint-Saturnin-sur-Loire;1333;33;1366
49;331;Segré-en-Anjou Bleu;49;319;Saint-Sauveur-de-Flée;314;15;329
49;069;Orée d'Anjou;49;320;Saint-Sauveur-de-Landemont;976;18;994
49;029;Blaison-Saint-Sulpice;49;322;Saint-Sulpice;202;5;207
49;323;Verrières-en-Anjou;49;323;Saint-Sylvain-d'Anjou;4974;261;5235
49;218;Montrevault-sur-Èvre;49;324;La Salle-et-Chapelle-Aubry;1270;25;1295
49;092;Chemillé-en-Anjou;49;325;La Salle-de-Vihiers;965;28;993
49;050;Brissac Loire Aubance;49;327;Saulgé-l'Hôpital;602;15;617
49;331;Segré-en-Anjou Bleu;49;331;Segré;7034;325;7359
49;080;Les Hauts-d'Anjou;49;335;Sœurdres;379;8;387
49;377;Rives-du-Loir-en-Anjou;49;337;Soucelles;2587;39;2626
49;373;Lys-Haut-Layon;49;342;Tancoigné;312;7;319
49;345;Bellevigne-en-Layon;49;345;Thouarcé;1976;40;2016
49;261;Gennes-Val-de-Loire;49;346;Le Thoureil;408;19;427
49;373;Lys-Haut-Layon;49;348;Tigné;725;17;742
49;301;Sèvremoine;49;349;Tillières;1890;43;1933
49;301;Sèvremoine;49;350;Torfou;2250;51;2301
49;092;Chemillé-en-Anjou;49;351;La Tourlandry;1438;42;1480
49;248;Ombrée d'Anjou;49;354;Le Tremblay;418;5;423
49;373;Lys-Haut-Layon;49;356;Trémont;356;8;364
49;069;Orée d'Anjou;49;360;La Varenne;1823;34;1857
49;050;Brissac Loire Aubance;49;363;Vauchrétien;1572;39;1611
49;125;Doué-en-Anjou;49;365;Les Verchers-sur-Layon;865;19;884
49;248;Ombrée d'Anjou;49;366;Vergonnes;276;3;279
49;367;Erdre-en-Anjou;49;367;Vern-d'Anjou;2317;32;2349
49;018;Baugé-en-Anjou;49;372;Le Vieil-Baugé;1249;26;1275
49;373;Lys-Haut-Layon;49;373;Vihiers;2294;46;2340
49;023;Beaupréau-en-Mauges;49;375;Villedieu-la-Blouère;2506;75;2581
49;183;Val d'Erdre-Auxence;49;376;Villemoisan;683;8;691
49;377;Rives-du-Loir-en-Anjou;49;377;Villevêque;3055;50;3105
49;373;Lys-Haut-Layon;49;379;Le Voide;668;18;686
49;018;Baugé-en-Anjou;49;380;Vaulandry;305;6;311
49;160;Ingrandes-Le Fresne sur Loire;49;382;Le Fresne-sur-Loire;994;23;1017
50;041;La Hague;50;001;Acqueville;616;17;633
50;550;Saint-Sauveur-Villages;50;007;Ancteville;231;1;232
50;565;Sartilly-Baie-Bocage;50;009;Angey;289;7;296
50;099;Carentan-les-Marais;50;010;Angoville-au-Plain;111;2;113
50;215;Gouville-sur-Mer;50;014;Anneville-sur-Mer;242;7;249
50;487;Saint-James;50;018;Argouges;501;1;502
50;041;La Hague;50;020;Auderville;223;6;229
50;236;La Haye;50;035;Baudreville;75;1;76
50;260;Juvigny les Vallées;50;037;La Bazoge;141;7;148
50;041;La Hague;50;041;Beaumont-Hague;1370;39;1409
50;260;Juvigny les Vallées;50;043;Bellefontaine;139;5;144
50;188;Folligny;50;047;La Beslière;159;5;164
50;523;Sainte-Mère-Église;50;051;Beuzeville-au-Plain;42;0;42
50;256;Isigny-le-Buat;50;053;Les Biards;416;10;426
50;359;Mortain-Bocage;50;056;Bion;374;14;388
50;041;La Hague;50;057;Biville;500;14;514
50;215;Gouville-sur-Mer;50;061;Boisroger;232;3;235
50;236;La Haye;50;063;Bolleville;360;6;366
50;041;La Hague;50;073;Branville-Hague;171;5;176
50;601;Torigny-les-Villes;50;075;Brectouville;169;2;171
50;099;Carentan-les-Marais;50;080;Brévands;305;7;312
50;082;Bricquebec-en-Cotentin;50;082;Bricquebec;4104;59;4163
50;099;Carentan-les-Marais;50;089;Brucheville;131;3;134
50;090;Buais-Les-Monts;50;090;Buais;486;7;493
50;095;Canisy;50;095;Canisy;1037;25;1062
50;099;Carentan-les-Marais;50;099;Carentan;441;13;454
50;487;Saint-James;50;100;Carnet;494;9;503
50;523;Sainte-Mère-Église;50;103;Carquebut;309;3;312
50;099;Carentan-les-Marais;50;107;Catz;107;1;108
50;256;Isigny-le-Buat;50;113;Chalandrey;299;4;303
50;565;Sartilly-Baie-Bocage;50;116;Champcey;236;5;241
50;431;Remilly Les Marais;50;119;Les Champs-de-Losque;196;2;198
50;239;Thèreval;50;123;La Chapelle-en-Juger;657;14;671
50;260;Juvigny les Vallées;50;125;Chasseguey;82;2;84
50;523;Sainte-Mère-Église;50;127;Chef-du-Pont;645;5;650
50;393;Percy-en-Normandie;50;128;Le Chefresne;305;4;309
50;129;Cherbourg-en-Cotentin;50;129;Cherbourg-Octeville;34799;1027;35826
50;260;Juvigny les Vallées;50;131;Chérencé-le-Roussel;275;9;284
50;168;Ducey-Les Chéris;50;132;Les Chéris;258;8;266
50;391;Grandparigny;50;133;Chèvreville;199;9;208
50;363;Moyon Villages;50;134;Chevry;108;0;108
50;273;Montsenelle;50;136;Coigny;167;4;171
50;419;Quettreville-sur-Sienne;50;140;Contrières;373;9;382
50;487;Saint-James;50;154;La Croix-Avranchin;437;12;449
50;412;Port-Bail-sur-Mer;50;160;Denneville;559;13;572
50;041;La Hague;50;163;Digulleville;260;7;267
50;168;Ducey-Les Chéris;50;168;Ducey;2569;51;2620
50;523;Sainte-Mère-Église;50;170;Écoquenéauville;99;4;103
50;041;La Hague;50;171;Éculleville;33;1;34
50;129;Cherbourg-en-Cotentin;50;173;Équeurdreville-Hainneville;16151;476;16627
50;591;Le Teilleul;50;179;Ferrières;49;0;49
50;041;La Hague;50;187;Flottemanville-Hague;974;28;1002
50;436;Romagny Fontenay;50;189;Fontenay;310;8;318
50;523;Sainte-Mère-Église;50;191;Foucarville;119;3;122
50;197;Gavray-sur-Sienne;50;197;Gavray;1411;18;1429
50;601;Torigny-les-Villes;50;202;Giéville;685;12;697
50;129;Cherbourg-en-Cotentin;50;203;La Glacerie;5916;174;6090
50;236;La Haye;50;204;Glatigny;141;4;145
50;546;Bourgvallées;50;213;Gourfaleur;467;12;479
50;215;Gouville-sur-Mer;50;215;Gouville-sur-Mer;2128;50;2178
50;041;La Hague;50;220;Gréville-Hague;677;19;696
50;419;Quettreville-sur-Sienne;50;223;Guéhébert;138;1;139
50;601;Torigny-les-Villes;50;224;Guilberville;1236;15;1251
50;236;La Haye;50;236;La Haye-du-Puits;1460;68;1528
50;239;Thèreval;50;239;Hébécrevon;1136;31;1167
50;041;La Hague;50;242;Herqueville;148;4;152
50;419;Quettreville-sur-Sienne;50;244;Hérenguerville;203;6;209
50;591;Le Teilleul;50;245;Heussé;210;4;214
50;099;Carentan-les-Marais;50;249;Houesville;246;4;250
50;591;Le Teilleul;50;254;Husson;168;6;174
50;419;Quettreville-sur-Sienne;50;255;Hyenville;365;13;378
50;041;La Hague;50;257;Jobourg;501;14;515
50;260;Juvigny les Vallées;50;260;Juvigny-le-Tertre;606;10;616
50;273;Montsenelle;50;273;Lithaire;576;8;584
50;292;Marigny-Le-Lozon;50;280;Lozon;308;4;312
50;410;Pontorson;50;284;Macey;108;0;108
50;256;Isigny-le-Buat;50;286;La Mancellière;274;12;286
50;546;Bourgvallées;50;287;La Mancellière-sur-Vire;528;14;542
50;292;Marigny-Le-Lozon;50;292;Marigny;2415;54;2469
50;391;Grandparigny;50;293;Martigny;315;11;326
50;197;Gavray-sur-Sienne;50;301;Le Mesnil-Amand;177;3;180
50;256;Isigny-le-Buat;50;306;Le Mesnil-Bœufs;181;5;186
50;550;Saint-Sauveur-Villages;50;308;Le Mesnilbus;380;3;383
50;188;Folligny;50;309;Le Mesnil-Drey;226;4;230
50;546;Bourgvallées;50;313;Le Mesnil-Herman;142;1;143
50;363;Moyon Villages;50;316;Le Mesnil-Opac;247;12;259
50;260;Juvigny les Vallées;50;318;Le Mesnil-Rainfray;210;1;211
50;197;Gavray-sur-Sienne;50;320;Le Mesnil-Rogues;171;3;174
50;256;Isigny-le-Buat;50;322;Le Mesnil-Thébault;277;13;290
50;260;Juvigny les Vallées;50;323;Le Mesnil-Tôve;230;5;235
50;431;Remilly Les Marais;50;325;Le Mesnil-Vigot;218;4;222
50;391;Grandparigny;50;329;Milly;335;9;344
50;236;La Haye;50;330;Mobecq;236;7;243
50;487;Saint-James;50;337;Montanel;337;2;339
50;388;Orval sur Sienne;50;339;Montchaton;293;7;300
50;236;La Haye;50;343;Montgardon;468;7;475
50;256;Isigny-le-Buat;50;344;Montgothier;235;10;245
50;256;Isigny-le-Buat;50;346;Montigny;233;6;239
50;099;Carentan-les-Marais;50;348;Montmartin-en-Graignes;611;6;617
50;215;Gouville-sur-Mer;50;354;Montsurvent;445;7;452
50;565;Sartilly-Baie-Bocage;50;355;Montviron;343;4;347
50;359;Mortain-Bocage;50;359;Mortain;1527;173;1700
50;363;Moyon Villages;50;363;Moyon;1088;23;1111
50;256;Isigny-le-Buat;50;367;Naftel;174;6;180
50;590;Le Tanu;50;377;Noirpalu;106;1;107
50;492;Saint-Jean-d'Elle;50;380;Notre-Dame-d'Elle;181;3;184
50;359;Mortain-Bocage;50;381;Notre-Dame-du-Touchet;610;10;620
50;041;La Hague;50;385;Omonville-la-Petite;124;4;128
50;041;La Hague;50;386;Omonville-la-Rogue;447;13;460
50;388;Orval sur Sienne;50;388;Orval;879;26;905
50;391;Grandparigny;50;391;Parigny;1786;45;1831
50;393;Percy-en-Normandie;50;393;Percy;2300;100;2400
50;082;Bricquebec-en-Cotentin;50;396;Les Perques;155;2;157
50;444;Saint-Amand-Villages;50;404;Placy-Montaigu;235;2;237
50;409;Pont-Hébert;50;409;Pont-Hébert;1575;35;1610
50;410;Pontorson;50;410;Pontorson;3858;70;3928
50;412;Port-Bail-sur-Mer;50;412;Portbail;1502;44;1546
50;492;Saint-Jean-d'Elle;50;414;Précorbin;525;7;532
50;273;Montsenelle;50;415;Prétot-Sainte-Suzanne;299;3;302
50;129;Cherbourg-en-Cotentin;50;416;Querqueville;4998;147;5145
50;082;Bricquebec-en-Cotentin;50;418;Quettetot;732;14;746
50;419;Quettreville-sur-Sienne;50;419;Quettreville-sur-Sienne;1445;33;1478
50;523;Sainte-Mère-Église;50;427;Ravenoville;234;1;235
50;431;Remilly Les Marais;50;431;Remilly-sur-Lozon;645;6;651
50;565;Sartilly-Baie-Bocage;50;434;La Rochelle-Normande;352;11;363
50;436;Romagny Fontenay;50;436;Romagny;960;35;995
50;550;Saint-Sauveur-Villages;50;438;La Ronde-Haye;341;7;348
50;167;Dragey-Ronthon;50;439;Ronthon;226;7;233
50;639;Villedieu-les-Poêles-Rouffigny;50;440;Rouffigny;313;4;317
50;492;Saint-Jean-d'Elle;50;441;Rouxeville;388;10;398
50;444;Saint-Amand-Villages;50;444;Saint-Amand;2279;56;2335
50;550;Saint-Sauveur-Villages;50;449;Saint-Aubin-du-Perron;238;3;241
50;099;Carentan-les-Marais;50;458;Saint-Côme-du-Mont;461;10;471
50;041;La Hague;50;460;Sainte-Croix-Hague;798;23;821
50;095;Canisy;50;465;Saint-Ébremond-de-Bonfossé;711;30;741
50;564;Terre-et-Marais;50;470;Saint-Georges-de-Bohon;419;6;425
50;041;La Hague;50;477;Saint-Germain-des-Vaux;311;9;320
50;484;Saint-Hilaire-du-Harcouët;50;484;Saint-Hilaire-du-Harcouët;3678;251;3929
50;099;Carentan-les-Marais;50;485;Saint-Hilaire-Petitville;1375;25;1400
50;487;Saint-James;50;487;Saint-James;2753;66;2819
50;492;Saint-Jean-d'Elle;50;492;Saint-Jean-des-Baisants;1291;34;1325
50;359;Mortain-Bocage;50;494;Saint-Jean-du-Corail;257;2;259
50;273;Montsenelle;50;497;Saint-Jores;371;5;376
50;493;Saint-Jean-des-Champs;50;501;Saint-Léger;87;3;90
50;412;Port-Bail-sur-Mer;50;503;Saint-Lô-d'Ourville;484;6;490
50;591;Le Teilleul;50;508;Sainte-Marie-du-Bois;58;5;63
50;484;Saint-Hilaire-du-Harcouët;50;515;Saint-Martin-de-Landelles;1110;25;1135
50;025;Avranches;50;516;Saint-Martin-des-Champs;2490;76;2566
50;082;Bricquebec-en-Cotentin;50;520;Saint-Martin-le-Hébert;154;2;156
50;523;Sainte-Mère-Église;50;523;Sainte-Mère-Église;1573;30;1603
50;550;Saint-Sauveur-Villages;50;524;Saint-Michel-de-la-Pierre;196;6;202
50;099;Carentan-les-Marais;50;534;Saint-Pellerin;352;7;359
50;236;La Haye;50;544;Saint-Rémy-des-Landes;213;3;216
50;546;Bourgvallées;50;545;Saint-Romphaire;773;16;789
50;546;Bourgvallées;50;546;Saint-Samson-de-Bonfossé;896;22;918
50;550;Saint-Sauveur-Villages;50;550;Saint-Sauveur-Lendelin;1643;105;1748
50;090;Buais-Les-Monts;50;557;Saint-Symphorien-des-Monts;124;3;127
50;236;La Haye;50;558;Saint-Symphorien-le-Valois;809;21;830
50;493;Saint-Jean-des-Champs;50;561;Saint-Ursin;171;5;176
50;564;Terre-et-Marais;50;564;Sainteny;902;23;925
50;565;Sartilly-Baie-Bocage;50;565;Sartilly;1615;29;1644
50;215;Gouville-sur-Mer;50;573;Servigny;194;3;197
50;546;Bourgvallées;50;581;Soulles;498;4;502
50;582;Sourdeval;50;582;Sourdeval;2643;51;2694
50;197;Gavray-sur-Sienne;50;583;Sourdeval-les-Bois;221;2;223
50;236;La Haye;50;586;Surville;196;3;199
50;591;Le Teilleul;50;591;Le Teilleul;1178;12;1190
50;041;La Hague;50;600;Tonneville;588;17;605
50;601;Torigny-les-Villes;50;601;Torigni-sur-Vire;2344;28;2372
50;129;Cherbourg-en-Cotentin;50;602;Tourlaville;15925;469;16394
50;419;Quettreville-sur-Sienne;50;605;Trelly;671;10;681
50;041;La Hague;50;611;Urville-Nacqueville;2055;58;2113
50;082;Bricquebec-en-Cotentin;50;614;Le Valdécie;141;1;142
50;041;La Hague;50;620;Vasteville;1145;32;1177
50;550;Saint-Sauveur-Villages;50;622;Vaudrimesnil;445;10;455
50;041;La Hague;50;623;Vauville;316;9;325
50;582;Sourdeval;50;625;Vengeons;470;11;481
50;487;Saint-James;50;627;Vergoncey;188;9;197
50;410;Pontorson;50;630;Vessey;386;5;391
50;099;Carentan-les-Marais;50;631;Les Veys;482;8;490
50;256;Isigny-le-Buat;50;632;Vezins;257;7;264
50;492;Saint-Jean-d'Elle;50;635;Vidouville;142;2;144
50;099;Carentan-les-Marais;50;636;Vierville;31;0;31
50;359;Mortain-Bocage;50;638;Villechien;164;8;172
50;639;Villedieu-les-Poêles-Rouffigny;50;639;Villedieu-les-Poêles;3536;60;3596
50;487;Saint-James;50;640;Villiers-le-Pré;186;4;190
50;484;Saint-Hilaire-du-Harcouët;50;644;Virey;981;32;1013
50;082;Bricquebec-en-Cotentin;50;646;Le Vrétot;561;11;572
51;158;Val-des-Marais;51;021;Aulnay-aux-Planches;88;1;89
51;158;Val-des-Marais;51;024;Aulnizeux;28;2;30
51;030;Aÿ-Champagne;51;030;Ay;3560;54;3614
51;030;Aÿ-Champagne;51;064;Bisseuil;593;7;600
51;075;Bourgogne-Fresne;51;075;Bourgogne;1004;24;1028
51;171;Cormicy;51;171;Cormicy;1460;26;1486
51;075;Bourgogne-Fresne;51;261;Fresne-lès-Reims;428;9;437
51;612;Blancs-Coteaux;51;271;Gionges;203;96;299
51;564;Val de Livre;51;331;Louvois;327;4;331
51;030;Aÿ-Champagne;51;347;Mareuil-sur-Ay;1097;27;1124
51;158;Val-des-Marais;51;383;Morains;96;1;97
51;248;Fère-Champenoise;51;405;Normée;62;0;62
51;612;Blancs-Coteaux;51;411;Oger;535;6;541
52;182;Éclaron-Braucourt-Sainte-Livière;51;494;Sainte-Livière;269;3;272
51;564;Val de Livre;51;564;Tauxières-Mutry;276;13;289
51;611;Vert-Toulon;51;575;Toulon-la-Montagne;25;0;25
51;612;Blancs-Coteaux;51;612;Vertus;2290;93;2383
51;612;Blancs-Coteaux;51;651;Voipreux;216;5;221
51;171;Cormicy;51;664;Gernicourt;43;0;43
52;088;Ceffonds;52;010;Anglus;58;4;62
52;140;Colombey les Deux Églises;52;018;Argentolles;37;1;38
52;273;Larivière-Arnoncourt;52;020;Arnoncourt-sur-Apance;18;1;19
52;497;Troisfontaines-la-Ville;52;032;Avrainville;136;3;139
52;449;Saints-Geosmes;52;036;Balesmes-sur-Marne;236;7;243
52;400;Le Châtelet-sur-Meuse;52;041;Beaucharmoy;47;0;47
52;140;Colombey les Deux Églises;52;049;Biernes;43;0;43
52;140;Colombey les Deux Églises;52;052;Blaise;73;0;73
52;008;Andelot-Blancheville;52;054;Blancheville;101;2;103
52;064;Bourmont-entre-Meuse-et-Mouzon;52;064;Bourmont;395;26;421
52;182;Éclaron-Braucourt-Sainte-Livière;52;068;Braucourt;176;4;180
52;491;Thonnance-les-Moulins;52;071;Bressoncourt;3;2;5
52;123;Chevillon;52;073;Breuil-sur-Marne;108;2;110
52;197;Fayl-Billot;52;077;Broncourt;61;1;62
52;121;Chaumont;52;078;Brottes;765;42;807
52;491;Thonnance-les-Moulins;52;080;Brouthières;8;0;8
52;426;Rizaucourt-Buchey;52;081;Buchey;22;0;22
52;140;Colombey les Deux Églises;52;100;Champcourt;41;2;43
52;432;Rolampont;52;111;Charmoilles;86;4;90
52;197;Fayl-Billot;52;112;Charmoy;82;2;84
52;189;Le Val-d'Esnoms;52;117;Chatoillenot;123;8;131
52;074;Breuvannes-en-Bassigny;52;139;Colombey-lès-Choiseul;98;4;102
52;140;Colombey les Deux Églises;52;140;Colombey-les-Deux-Églises;360;12;372
52;083;Champsevraine;52;143;Corgirnon;300;7;307
52;269;Langres;52;144;Corlée;204;4;208
52;189;Le Val-d'Esnoms;52;150;Courcelles-Val-d'Esnoms;122;0;122
52;114;Châteauvillain;52;153;Créancey;186;3;189
52;205;Foulain;52;154;Crenay;229;2;231
52;353;Nogent;52;176;Donnemarie;59;3;62
52;411;Rives Dervoises;52;180;Droyes;426;4;430
52;332;Val-de-Meuse;52;186;Épinant;77;1;78
52;187;Épizon;52;187;Épizon;138;2;140
52;353;Nogent;52;191;Essey-les-Eaux;52;0;52
52;114;Châteauvillain;52;192;Essey-les-Ponts;100;0;100
52;497;Troisfontaines-la-Ville;52;202;Flornoy;83;3;86
52;377;Parnoy-en-Bassigny;52;209;Fresnoy-en-Bassigny;121;3;124
70;122;Champlitte;52;210;Frettes;114;4;118
52;060;Bourbonne-les-Bains;52;215;Genrupt;58;0;58
52;064;Bourmont-entre-Meuse-et-Mouzon;52;224;Gonaincourt;52;0;52
52;064;Bourmont-entre-Meuse-et-Mouzon;52;225;Goncourt;223;8;231
52;265;Bayard-sur-Marne;52;226;Gourzon;485;11;496
52;288;Lezéville;52;236;Harméville;37;1;38
52;140;Colombey les Deux Églises;52;238;Harricourt;42;0;42
52;529;Villegusien-le-Lac;52;239;Heuilley-Cotton;288;7;295
52;246;Humes-Jorquenay;52;252;Jorquenay;141;3;144
52;251;Jonchery;52;259;Laharmand;126;4;130
52;094;Vals-des-Tilles;52;261;Lamargelle-aux-Bois;20;0;20
52;140;Colombey les Deux Églises;52;262;Lamothe-en-Blaisy;66;1;67
52;173;Domremy-Landéville;52;263;Landéville;16;1;17
52;288;Lezéville;52;268;Laneuville-au-Bois;37;0;37
52;432;Rolampont;52;270;Lannes;175;0;175
52;140;Colombey les Deux Églises;52;279;Lavilleneuve-aux-Fresnes;22;0;22
52;332;Val-de-Meuse;52;281;Lécourt;56;1;57
52;332;Val-de-Meuse;52;283;Lénizeul;89;0;89
52;411;Rives Dervoises;52;293;Longeville-sur-la-Laines;408;9;417
52;411;Rives Dervoises;52;296;Louze;299;11;310
52;456;Saint-Urbain-Maconcourt;52;299;Maconcourt;37;2;39
52;058;Bologne;52;309;Marault;244;5;249
52;114;Châteauvillain;52;314;Marmesse;62;0;62
52;332;Val-de-Meuse;52;317;Maulain;63;0;63
52;074;Breuvannes-en-Bassigny;52;324;Meuvy;78;1;79
52;388;Pierremont-sur-Amance;52;329;Montesson;38;0;38
52;331;La Porte du Der;52;331;Montier-en-Der;1947;52;1999
52;242;Haute-Amance;52;333;Montlandon;170;1;171
52;469;Semoutiers-Montsaon;52;339;Montsaon;399;6;405
52;405;Le Montsaugeonnais;52;340;Montsaugeon;80;1;81
52;094;Vals-des-Tilles;52;345;Musseau;49;0;49
52;064;Bourmont-entre-Meuse-et-Mouzon;52;351;Nijon;100;0;100
52;353;Nogent;52;361;Odival;187;4;191
52;274;Latrecey-Ormoy-sur-Aube;52;368;Ormoy-sur-Aube;54;3;57
52;187;Épizon;52;379;Pautaines-Augeville;21;2;23
52;292;Longeau-Percey;52;381;Percey-le-Pautel;206;0;206
52;529;Villegusien-le-Lac;52;387;Piépape;93;1;94
52;384;Perrogney-les-Fontaines;52;389;Pierrefontaines;28;0;28
52;529;Villegusien-le-Lac;52;402;Prangey;189;4;193
52;140;Colombey les Deux Églises;52;404;Pratz;9;0;9
52;405;Le Montsaugeonnais;52;405;Prauthoy;382;9;391
52;265;Bayard-sur-Marne;52;408;Prez-sur-Marne;214;4;218
52;211;Froncles;52;409;Provenchères-sur-Marne;57;0;57
52;332;Val-de-Meuse;52;410;Provenchères-sur-Meuse;234;5;239
52;411;Rives Dervoises;52;411;Puellemontier;194;16;210
52;050;Biesles;52;412;Le Puits-des-Mèzes;195;7;202
52;332;Val-de-Meuse;52;417;Ravennefontaines;67;2;69
52;332;Val-de-Meuse;52;418;Récourt;62;0;62
52;331;La Porte du Der;52;427;Robert-Magny;278;4;282
52;058;Bologne;52;434;Roôcourt-la-Côte;206;3;209
52;242;Haute-Amance;52;435;Rosoy-sur-Amance;193;3;196
52;479;Sommevoire;52;441;Rozières;65;1;66
52;449;Saints-Geosmes;52;449;Saints-Geosmes;879;24;903
52;031;Autreville-sur-la-Renne;52;451;Saint-Martin-sur-la-Renne;83;1;84
52;529;Villegusien-le-Lac;52;454;Saint-Michel;105;0;105
52;251;Jonchery;52;460;Sarcicourt;179;3;182
52;177;Doulaincourt-Saucourt;52;462;Saucourt-sur-Rognon;140;0;140
52;088;Ceffonds;52;466;Sauvage-Magny;52;1;53
52;118;Chatonrupt-Sommermont;52;477;Sommermont;52;1;53
52;123;Chevillon;52;478;Sommeville;280;5;285
52;491;Thonnance-les-Moulins;52;481;Soulaincourt;27;0;27
52;242;Haute-Amance;52;496;Troischamps;65;0;65
52;432;Rolampont;52;498;Tronchoy;55;2;57
52;031;Autreville-sur-la-Renne;52;501;Valdelancourt;90;4;94
52;544;Voisey;52;508;Vaux-la-Douce;25;0;25
52;405;Le Montsaugeonnais;52;509;Vaux-sous-Aubigny;687;9;696
52;383;Perrancey-les-Vieux-Moulins;52;521;Vieux-Moulins;76;1;77
52;060;Bourbonne-les-Bains;52;527;Villars-Saint-Marcellin;102;1;103
52;529;Villegusien-le-Lac;52;529;Villegusien-le-Lac;305;4;309
52;094;Vals-des-Tilles;52;530;Villemervry;28;0;28
52;094;Vals-des-Tilles;52;531;Villemoron;48;1;49
52;497;Troisfontaines-la-Ville;52;532;Villiers-aux-Bois;116;1;117
52;178;Doulevant-le-Château;52;533;Villiers-aux-Chênes;60;3;63
52;230;Gudmont-Villiers;52;537;Villiers-sur-Marne;99;2;101
53;124;Prée-d'Anjou;53;004;Ampoigné;557;9;566
53;029;Bierné-les-Villages;53;006;Argenton-Notre-Dame;216;4;220
53;062;Château-Gontier-sur-Mayenne;53;014;Azé;3386;139;3525
53;017;Val-du-Maine;53;017;Ballée;698;25;723
53;029;Bierné-les-Villages;53;029;Bierné;680;19;699
53;228;Blandouet-Saint Jean;53;032;Blandouet;185;2;187
53;118;Le Housseau-Brétignolles;53;044;Brétignolles-le-Moulin;57;0;57
53;255;Sainte-Suzanne-et-Chammes;53;050;Chammes;386;4;390
53;062;Château-Gontier-sur-Mayenne;53;062;Château-Gontier;11683;478;12161
53;097;Évron;53;065;Châtres-la-Forêt;790;19;809
53;161;Montsûrs;53;092;Deux-Évailles;193;5;198
53;017;Val-du-Maine;53;095;Épineux-le-Seguin;261;3;264
53;097;Évron;53;097;Évron;7109;195;7304
53;104;Gennes-Longuefuye;53;104;Gennes-sur-Glaize;1001;21;1022
53;124;Prée-d'Anjou;53;124;Laigné;832;34;866
53;136;La Roche-Neuville;53;136;Loigné-sur-Mayenne;954;31;985
53;137;Loiron-Ruillé;53;137;Loiron;1805;29;1834
53;104;Gennes-Longuefuye;53;138;Longuefuye;336;8;344
53;161;Montsûrs;53;159;Montourtier;365;5;370
53;161;Montsûrs;53;161;Montsûrs;1975;41;2016
53;185;Pré-en-Pail-Saint-Samson;53;185;Pré-en-Pail;1877;76;1953
53;137;Loiron-Ruillé;53;194;Ruillé-le-Gravelais;935;23;958
53;161;Montsûrs;53;205;Saint-Céneré;476;7;483
53;097;Évron;53;207;Saint-Christophe-du-Luat;768;15;783
53;062;Château-Gontier-sur-Mayenne;53;215;Saint-Fort;1776;73;1849
53;228;Blandouet-Saint Jean;53;228;Saint-Jean-sur-Erve;376;11;387
53;029;Bierné-les-Villages;53;231;Saint-Laurent-des-Mortiers;180;4;184
53;249;Vimartin-sur-Orthe;53;239;Saint-Martin-de-Connée;416;6;422
53;029;Bierné-les-Villages;53;241;Saint-Michel-de-Feins;178;4;182
53;161;Montsûrs;53;244;Saint-Ouën-des-Vallons;182;1;183
53;249;Vimartin-sur-Orthe;53;249;Saint-Pierre-sur-Orthe;468;7;475
53;185;Pré-en-Pail-Saint-Samson;53;252;Saint-Samson;418;8;426
53;136;La Roche-Neuville;53;254;Saint-Sulpice;247;8;255
53;255;Sainte-Suzanne-et-Chammes;53;255;Sainte-Suzanne;865;12;877
53;249;Vimartin-sur-Orthe;53;274;Vimarcé;236;0;236
54;099;Val de Briey;54;099;Briey;5601;186;5787
54;099;Val de Briey;54;341;Mance;605;14;619
54;099;Val de Briey;54;342;Mancieulles;1835;28;1863
54;557;Bois-de-Haye;54;506;Sexey-les-Bois;387;6;393
54;557;Bois-de-Haye;54;557;Velaine-en-Haye;1931;91;2022
55;040;Beausite;55;006;Amblaincourt;15;0;15
55;184;Euville;55;016;Aulnois-sous-Vertuzey;312;10;322
55;388;Noyers-Auzécourt;55;019;Auzécourt;90;3;93
55;117;Clermont-en-Argonne;55;020;Auzéville-en-Argonne;185;6;191
55;150;Demange-Baudignécourt;55;030;Baudignécourt;61;0;61
55;551;Vigneulles-lès-Hattonchâtel;55;052;Billy-sous-les-Côtes;122;1;123
55;385;Nixéville-Blercourt;55;056;Blercourt;143;1;144
55;389;Nubécourt;55;086;Bulainville;44;2;46
55;093;Buxières-sous-les-Côtes;55;092;Buxerulles;80;4;84
55;358;Chanteraine;55;112;Chennevières;29;0;29
55;258;Geville;55;126;Corniéville;177;6;183
55;518;Cousances-lès-Triconville;55;131;Cousances-au-Bois;62;0;62
55;551;Vigneulles-lès-Hattonchâtel;55;136;Creuë;243;6;249
55;274;Lamorville;55;151;Deuxnouds-aux-Bois;46;1;47
55;040;Beausite;55;152;Deuxnouds-devant-Beauzée;53;2;55
55;179;Erneville-aux-Bois;55;161;Domremy-aux-Bois;55;2;57
55;537;Douaumont-Vaux;55;164;Douaumont;4;0;4
55;442;Raival;55;176;Érize-la-Grande;95;1;96
55;389;Nubécourt;55;190;Fleury-sur-Aire;85;1;86
55;123;Les Hauts-de-Chée;55;203;Génicourt-sous-Condé;40;4;44
55;026;Badonvilliers-Gérauvilliers;55;205;Gérauvilliers;59;1;60
55;258;Geville;55;213;Gironville-sous-les-Côtes;190;6;196
55;267;Lachaussée;55;223;Hadonville-lès-Lachaussée;36;0;36
55;571;Vilosnes-Haraumont;55;230;Haraumont;49;2;51
55;123;Les Hauts-de-Chée;55;231;Hargeville-sur-Chée;128;2;130
55;551;Vigneulles-lès-Hattonchâtel;55;233;Hattonchâtel;80;2;82
55;551;Vigneulles-lès-Hattonchâtel;55;234;Hattonville;186;4;190
55;500;Spincourt;55;235;Haucourt-la-Rigole;64;0;64
55;267;Lachaussée;55;238;Haumont-lès-Lachaussée;78;1;79
55;002;Abaucourt-Hautecourt;55;240;Hautecourt-lès-Broville;31;2;33
55;500;Spincourt;55;249;Houdelaucourt-sur-Othain;56;0;56
55;117;Clermont-en-Argonne;55;259;Jubécourt;70;0;70
55;386;Nonsard-Lamarche;55;273;Lamarche-en-Woëvre;25;0;25
55;274;Lamorville;55;283;Lavignéville;58;1;59
55;276;Landrecourt-Lempire;55;287;Lempire-aux-Bois;53;1;54
55;012;Apremont-la-Forêt;55;294;Liouville;61;1;62
55;123;Les Hauts-de-Chée;55;305;Louppy-sur-Chée;126;2;128
55;179;Erneville-aux-Bois;55;308;Loxéville;41;0;41
55;215;Gondrecourt-le-Château;55;309;Luméville-en-Ornois;57;1;58
55;114;Chonville-Malaumont;55;314;Malaumont;35;0;35
55;123;Les Hauts-de-Chée;55;318;Les Marats;109;2;111
55;012;Apremont-la-Forêt;55;319;Marbotte;62;2;64
55;254;Les Trois-Domaines;55;342;Mondrecourt;24;0;24
55;358;Chanteraine;55;390;Oëy;61;2;63
55;500;Spincourt;55;392;Ollières;13;0;13
55;191;Foameix-Ornel;55;393;Ornel;13;2;15
55;117;Clermont-en-Argonne;55;402;Parois;76;3;79
55;497;Les Souhesmes-Rampont;55;413;Rampont;91;2;93
55;500;Spincourt;55;418;Réchicourt;60;2;62
55;254;Les Trois-Domaines;55;432;Rignaucourt;25;0;25
55;148;Delouze-Rosières;55;441;Rosières-en-Blois;44;1;45
55;012;Apremont-la-Forêt;55;451;Saint-Agnant-sous-les-Côtes;97;0;97
55;551;Vigneulles-lès-Hattonchâtel;55;455;Saint-Benoît-en-Woëvre;38;0;38
55;530;Valbois;55;478;Savonnières-en-Woëvre;13;0;13
55;517;Seuil-d'Argonne;55;480;Senard;62;1;63
55;530;Valbois;55;483;Senonville;45;0;45
55;040;Beausite;55;486;Seraucourt;12;0;12
55;423;Rembercourt-Sommaisne;55;491;Sommaisne;22;0;22
55;274;Lamorville;55;499;Spada;93;2;95
55;215;Gondrecourt-le-Château;55;513;Tourailles-sous-Bois;21;1;22
55;537;Douaumont-Vaux;55;537;Vaux-devant-Damloup;75;0;75
55;472;Saulvaux;55;538;Vaux-la-Grande;21;1;22
55;472;Saulvaux;55;539;Vaux-la-Petite;20;1;21
55;186;Fains-Véel;55;542;Véel;353;11;364
55;184;Euville;55;548;Vertuzey;227;4;231
55;551;Vigneulles-lès-Hattonchâtel;55;550;Viéville-sous-les-Côtes;215;7;222
55;184;Euville;55;558;Ville-Issey;302;5;307
55;093;Buxières-sous-les-Côtes;55;585;Woinville;79;3;82
56;197;Val d'Oust;56;037;La Chapelle-Caro;1455;51;1506
56;061;La Gacilly;56;038;La Chapelle-Gaceline;781;17;798
56;213;Saint-Gérand-Croixanvec;56;049;Croixanvec;177;4;181
56;102;Forges de Lanouée;56;059;Les Forges;423;6;429
56;061;La Gacilly;56;061;La Gacilly;2294;56;2350
56;061;La Gacilly;56;064;Glénac;899;32;931
56;102;Forges de Lanouée;56;102;Lanouée;1725;45;1770
56;144;Évellys;56;142;Moustoir-Remungol;726;14;740
56;144;Évellys;56;144;Naizin;1770;50;1820
56;251;Theix-Noyalo;56;150;Noyalo;928;20;948
56;033;Carentoir;56;183;Quelneuc;509;9;518
56;197;Val d'Oust;56;187;Quily;362;6;368
56;144;Évellys;56;192;Remungol;950;15;965
56;197;Val d'Oust;56;197;Le Roc-Saint-André;965;21;986
56;213;Saint-Gérand-Croixanvec;56;213;Saint-Gérand;1139;28;1167
57;021;Ancy-Dornot;57;021;Ancy-sur-Moselle;1343;26;1369
57;086;Belles-Forêts;57;023;Angviller-lès-Bisping;86;1;87
57;209;Faulquemont;57;135;Chémery;107;3;110
57;148;Colligny-Maizery;57;148;Colligny;390;7;397
57;132;Château-Salins;57;157;Coutures;200;4;204
57;021;Ancy-Dornot;57;184;Dornot;166;3;169
57;252;Gomelange;57;279;Guirlange;29;0;29
57;097;Boulay-Moselle;57;285;Halling-lès-Boulay;128;1;129
57;155;Courcelles-Chaussy;57;378;Landonvillers;387;5;392
57;150;Condé-Northen;57;420;Loutremange;22;0;22
57;148;Colligny-Maizery;57;432;Maizery;178;4;182
57;439;Manderen-Ritzing;57;439;Manderen;405;9;414
57;482;Ogy-Montoy-Flanville;57;482;Montoy-Flanville;1299;18;1317
57;482;Ogy-Montoy-Flanville;57;523;Ogy;478;11;489
57;578;Rezonville-Vionville;57;578;Rezonville;304;6;310
57;439;Manderen-Ritzing;57;585;Ritzing;197;4;201
57;578;Rezonville-Vionville;57;722;Vionville;190;1;191
58;204;Vaux d'Amognes;58;022;Balleray;200;3;203
58;026;Beaulieu;58;026;Beaulieu;24;1;25
58;086;Cosne-Cours-sur-Loire;58;091;Cours;1657;43;1700
58;026;Beaulieu;58;100;Dompierre-sur-Héry;71;4;75
58;026;Beaulieu;58;167;Michaugues;46;4;50
58;204;Vaux d'Amognes;58;204;Ourouër;338;4;342
59;588;Téteghem-Coudekerque-Village;59;154;Coudekerque-Village;1376;35;1411
59;183;Dunkerque;59;248;Fort-Mardyck;3453;50;3503
59;260;Ghyvelde;59;260;Ghyvelde;3139;48;3187
59;350;Lille;59;298;Hellemmes-Lille;18586;147;18733
59;350;Lille;59;355;Lomme;28012;222;28234
59;183;Dunkerque;59;380;Mardyck;276;4;280
59;260;Ghyvelde;59;404;Les Moëres;972;11;983
59;183;Dunkerque;59;540;Saint-Pol-sur-Mer;20271;295;20566
59;631;Walincourt-Selvigny;59;561;Selvigny;399;6;405
59;588;Téteghem-Coudekerque-Village;59;588;Téteghem;6882;181;7063
60;088;Bornel;60;018;Anserville;463;15;478
60;256;Montchevreuil;60;038;Bachivillers;567;10;577
60;054;Les Hauts-Talican;60;054;Beaumont-les-Nonains;334;7;341
60;209;La Corne-en-Vexin;60;080;Boissy-le-Bois;190;5;195
60;245;Formerie;60;096;Boutavent;95;1;96
60;196;La Drenne;60;196;Le Déluge;584;5;589
60;209;La Corne-en-Vexin;60;209;Énencourt-le-Sec;188;3;191
60;245;Formerie;60;245;Formerie;2014;23;2037
60;088;Bornel;60;246;Fosseuse;786;8;794
60;256;Montchevreuil;60;256;Fresneaux-Montchevreuil;757;11;768
60;209;La Corne-en-Vexin;60;300;Hardivillers-en-Vexin;166;2;168
60;570;Saint-Crépin-Ibouvillers;60;417;Montherlant;160;0;160
60;196;La Drenne;60;453;La Neuville-d'Aumont;335;9;344
60;054;Les Hauts-Talican;60;455;La Neuville-Garnier;252;5;257
60;196;La Drenne;60;532;Ressons-l'Abbaye;128;2;130
60;570;Saint-Crépin-Ibouvillers;60;570;Saint-Crépin-Ibouvillers;1418;23;1441
60;054;Les Hauts-Talican;60;694;Villotran;287;7;294
61;167;La Ferté-en-Ouche;61;003;Anceins;198;3;201
61;168;La Ferté Macé;61;004;Antoigny;123;0;123
61;007;Athis-Val de Rouvre;61;007;Athis-de-l'Orne;2520;59;2579
61;474;Gouffern en Auge;61;009;Aubry-en-Exmes;321;10;331
61;491;Tourouvre au Perche;61;016;Autheuil;131;2;133
61;474;Gouffern en Auge;61;019;Avernes-sous-Exmes;82;1;83
61;211;Juvigny Val d'Andaine;61;025;La Baroche-sous-Lucé;383;9;392
61;153;Écouché-les-Vallées;61;027;Batilly;136;6;142
61;486;Tinchebray-Bocage;61;031;Beauchêne;248;3;251
61;211;Juvigny Val d'Andaine;61;033;Beaulandais;163;3;166
61;491;Tourouvre au Perche;61;045;Bivilliers;61;1;62
61;167;La Ferté-en-Ouche;61;047;Bocquencé;143;3;146
61;474;Gouffern en Auge;61;057;Le Bourg-Saint-Léonard;394;8;402
61;007;Athis-Val de Rouvre;61;058;Bréel;124;0;124
61;491;Tourouvre au Perche;61;059;Bresolettes;23;1;24
61;491;Tourouvre au Perche;61;065;Bubertré;131;7;138
61;007;Athis-Val de Rouvre;61;073;La Carneille;584;9;593
61;081;Chailloué;61;081;Chailloué;622;14;636
61;474;Gouffern en Auge;61;083;Chambois;384;7;391
61;491;Tourouvre au Perche;61;090;Champs;79;3;82
61;096;Rives d'Andaine;61;096;La Chapelle-d'Andaine;1454;25;1479
61;339;Putanges-le-Lac;61;106;Chênedouit;170;1;171
61;292;Montsecret-Clairefougère;61;109;Clairefougère;123;0;123
61;474;Gouffern en Auge;61;110;La Cochère;149;3;152
61;309;Perche en Nocé;61;112;Colonard-Corubert;241;6;247
61;116;Sablons sur Huisne;61;115;Condeau;360;10;370
61;116;Sablons sur Huisne;61;116;Condé-sur-Huisne;1250;18;1268
61;116;Sablons sur Huisne;61;125;Coulonges-les-Sablons;395;13;408
61;153;Écouché-les-Vallées;61;127;La Courbe;63;4;67
61;474;Gouffern en Auge;61;131;Courménil;120;2;122
61;096;Rives d'Andaine;61;135;Couterne;1011;18;1029
61;167;La Ferté-en-Ouche;61;136;Couvains;194;4;198
61;309;Perche en Nocé;61;144;Dancé;346;11;357
61;145;Domfront en Poiraie;61;145;Domfront;3449;100;3549
61;153;Écouché-les-Vallées;61;153;Écouché;1356;28;1384
61;196;Belforêt-en-Perche;61;154;Eperrais;107;4;111
61;324;Passais Villages;61;155;L'Épinay-le-Comte;165;1;166
61;474;Gouffern en Auge;61;157;Exmes;271;6;277
61;474;Gouffern en Auge;61;161;Fel;273;3;276
61;167;La Ferté-en-Ouche;61;167;La Ferté-Frênel;597;11;608
61;228;L'Orée-d'Écouves;61;172;Fontenai-les-Louvets;275;6;281
61;153;Écouché-les-Vallées;61;173;Fontenai-sur-Orne;242;6;248
61;339;Putanges-le-Lac;61;174;La Forêt-Auvray;169;4;173
61;486;Tinchebray-Bocage;61;177;Frênes;819;23;842
61;339;Putanges-le-Lac;61;179;La Fresnaye-au-Sauvage;228;4;232
61;167;La Ferté-en-Ouche;61;184;Gauville;548;17;565
61;484;Val-au-Perche;61;185;Gémages;114;0;114
61;096;Rives d'Andaine;61;186;Geneslay;271;8;279
61;167;La Ferté-en-Ouche;61;191;Glos-la-Ferrière;498;8;506
61;194;Monts-sur-Orne;61;194;Goulet;381;6;387
61;196;Belforêt-en-Perche;61;196;Le Gué-de-la-Chaîne;689;19;708
61;096;Rives d'Andaine;61;200;Haleine;246;41;287
61;145;Domfront en Poiraie;61;201;La Haute-Chapelle;544;14;558
61;484;Val-au-Perche;61;204;L'Hermitière;202;10;212
61;167;La Ferté-en-Ouche;61;205;Heugon;199;3;202
61;211;Juvigny Val d'Andaine;61;211;Juvigny-sous-Andaine;942;26;968
61;230;Longny les Villages;61;220;La Lande-sur-Eure;184;4;188
61;486;Tinchebray-Bocage;61;223;Larchamp;302;2;304
61;491;Tourouvre au Perche;61;226;Lignerolles;159;7;166
61;228;L'Orée-d'Écouves;61;228;Livaie;214;5;219
61;230;Longny les Villages;61;230;Longny-au-Perche;1292;23;1315
61;228;L'Orée-d'Écouves;61;231;Longuenoë;125;2;127
61;211;Juvigny Val d'Andaine;61;235;Loré;172;4;176
61;153;Écouché-les-Vallées;61;236;Loucé;110;1;111
61;211;Juvigny Val d'Andaine;61;239;Lucé;75;3;78
61;484;Val-au-Perche;61;246;Mâle;666;18;684
61;230;Longny les Villages;61;247;Malétable;102;1;103
61;375;Boischampré;61;249;Marcei;207;14;221
61;230;Longny les Villages;61;250;Marchainville;216;4;220
61;081;Chailloué;61;253;Marmouillé;127;7;134
61;339;Putanges-le-Lac;61;270;Ménil-Jean;117;2;119
61;230;Longny les Villages;61;280;Monceaux-au-Perche;82;0;82
61;167;La Ferté-en-Ouche;61;282;Monnai;253;3;256
61;194;Monts-sur-Orne;61;285;Montgaroult;365;7;372
61;292;Montsecret-Clairefougère;61;292;Montsecret;527;9;536
61;294;Mortrée;61;294;Mortrée;1012;20;1032
61;230;Longny les Villages;61;296;Moulicent;246;3;249
61;429;Charencey;61;299;Moussonvilliers;216;7;223
61;230;Longny les Villages;61;305;Neuilly-sur-Eure;638;11;649
61;081;Chailloué;61;306;Neuville-près-Sées;145;3;148
61;309;Perche en Nocé;61;309;Nocé;726;17;743
61;429;Charencey;61;311;Normandel;90;1;91
61;007;Athis-Val de Rouvre;61;313;Notre-Dame-du-Rocher;53;0;53
61;474;Gouffern en Auge;61;315;Omméel;113;3;116
61;196;Belforêt-en-Perche;61;318;Origny-le-Butin;89;4;93
61;460;Sap-en-Auge;61;320;Orville;105;0;105
61;324;Passais Villages;61;324;Passais;772;8;780
61;196;Belforêt-en-Perche;61;325;La Perrière;216;10;226
61;491;Tourouvre au Perche;61;335;La Poterie-au-Perche;133;1;134
61;309;Perche en Nocé;61;337;Préaux-du-Perche;483;25;508
61;491;Tourouvre au Perche;61;338;Prépotin;119;2;121
61;339;Putanges-le-Lac;61;339;Putanges-Pont-Écrepin;990;16;1006
61;339;Putanges-le-Lac;61;340;Rabodanges;177;2;179
61;491;Tourouvre au Perche;61;343;Randonnai;719;6;725
61;007;Athis-Val de Rouvre;61;353;Ronfeugerai;334;8;342
61;339;Putanges-le-Lac;61;354;Les Rotours;115;1;116
61;145;Domfront en Poiraie;61;355;Rouellé;187;3;190
61;484;Val-au-Perche;61;356;La Rouge;642;8;650
61;484;Val-au-Perche;61;359;Saint-Agnan-sur-Erre;166;5;171
61;339;Putanges-le-Lac;61;364;Saint-Aubert-sur-Orne;98;2;100
61;309;Perche en Nocé;61;368;Saint-Aubin-des-Grois;57;0;57
61;375;Boischampré;61;375;Saint-Christophe-le-Jajolet;239;2;241
61;486;Tinchebray-Bocage;61;377;Saint-Cornier-des-Landes;601;15;616
61;339;Putanges-le-Lac;61;378;Sainte-Croix-sur-Orne;76;0;76
61;211;Juvigny Val d'Andaine;61;380;Saint-Denis-de-Villenette;140;1;141
61;228;L'Orée-d'Écouves;61;383;Saint-Didier-sous-Écouves;159;3;162
61;294;Mortrée;61;403;Saint-Hilaire-la-Gérard;132;3;135
61;309;Perche en Nocé;61;409;Saint-Jean-de-la-Forêt;157;4;161
61;486;Tinchebray-Bocage;61;410;Saint-Jean-des-Bois;182;0;182
61;375;Boischampré;61;417;Saint-Loyer-des-Champs;369;14;383
61;463;Les Monts d'Andaine;61;428;Saint-Maurice-du-Désert;747;17;764
61;429;Charencey;61;429;Saint-Maurice-lès-Charencey;467;7;474
61;483;Bagnoles de l'Orne Normandie;61;431;Saint-Michel-des-Andaines;321;7;328
61;167;La Ferté-en-Ouche;61;434;Saint-Nicolas-des-Laitiers;78;0;78
61;196;Belforêt-en-Perche;61;437;Saint-Ouen-de-la-Cour;55;2;57
61;153;Écouché-les-Vallées;61;441;Saint-Ouen-sur-Maire;92;0;92
61;474;Gouffern en Auge;61;449;Saint-Pierre-la-Rivière;154;5;159
61;324;Passais Villages;61;455;Saint-Siméon;226;7;233
61;230;Longny les Villages;61;458;Saint-Victor-de-Réno;170;2;172
61;460;Sap-en-Auge;61;460;Le Sap;855;10;865
61;463;Les Monts d'Andaine;61;463;La Sauvagère;990;15;1005
61;007;Athis-Val de Rouvre;61;465;Ségrie-Fontaine;402;6;408
61;194;Monts-sur-Orne;61;468;Sentilly;127;1;128
61;211;Juvigny Val d'Andaine;61;469;Sept-Forges;249;7;256
61;153;Écouché-les-Vallées;61;470;Serans;201;6;207
61;196;Belforêt-en-Perche;61;471;Sérigny;352;12;364
61;474;Gouffern en Auge;61;474;Silly-en-Gouffern;397;13;410
61;474;Gouffern en Auge;61;477;Survie;162;1;163
61;007;Athis-Val de Rouvre;61;478;Taillebois;148;0;148
61;483;Bagnoles de l'Orne Normandie;61;483;Bagnoles-de-l'Orne;2399;40;2439
61;484;Val-au-Perche;61;484;Le Theil;1620;31;1651
61;486;Tinchebray-Bocage;61;486;Tinchebray;2589;37;2626
61;007;Athis-Val de Rouvre;61;489;Les Tourailles;59;1;60
61;491;Tourouvre au Perche;61;491;Tourouvre;1514;18;1532
61;474;Gouffern en Auge;61;496;Urou-et-Crennes;742;18;760
61;474;Gouffern en Auge;61;504;Villebadin;125;1;126
61;167;La Ferté-en-Ouche;61;506;Villers-en-Ouche;321;11;332
61;375;Boischampré;61;511;Vrigny;374;7;381
61;486;Tinchebray-Bocage;61;513;Yvrandes;155;6;161
62;473;Isbergues;62;110;Berguette;1810;17;1827
62;295;Enquin-lez-Guinegatte;62;294;Enguinegatte;452;7;459
62;295;Enquin-lez-Guinegatte;62;295;Enquin-les-Mines;1161;19;1180
62;471;Bellinghem;62;431;Herbelles;546;16;562
62;471;Bellinghem;62;471;Inghem;538;5;543
62;178;Bruay-la-Buissière;62;482;Labuissière;3620;58;3678
62;473;Isbergues;62;575;Molinghem;2762;27;2789
63;160;Aulhat-Flat;63;018;Aulhat-Saint-Privat;485;12;497
63;244;Chambaron sur Morge;63;068;Cellule;1263;17;1280
63;448;Le Vernet-Chaméane;63;078;Chaméane;165;5;170
63;226;Mur-sur-Allier;63;133;Dallet;1241;25;1266
63;160;Aulhat-Flat;63;160;Flat;445;21;466
63;226;Mur-sur-Allier;63;226;Mezel;2072;38;2110
63;244;Chambaron sur Morge;63;244;La Moutade;542;10;552
63;038;Besse-et-Saint-Anastaise;63;316;Saint-Anastaise;65;1;66
63;448;Le Vernet-Chaméane;63;448;Vernet-la-Varenne;627;80;707
64;225;Ance Féas;64;020;Ance;228;7;235
64;396;Mont;64;030;Arance;128;3;131
64;064;Asasp-Arros;64;055;Arros-d'Oloron;80;0;80
64;010;Aïcirits-Camou-Suhast;64;163;Camou-Mixe-Suhast;217;10;227
64;148;Bruges-Capbis-Mifaget;64;164;Capbis;63;5;68
64;168;Carresse-Cassaber;64;169;Cassaber;132;3;135
64;225;Ance Féas;64;225;Féas;387;7;394
64;396;Mont;64;248;Gouze;424;4;428
64;049;Aroue-Ithorots-Olhaïby;64;278;Ithorots-Olhaïby;43;2;45
64;396;Mont;64;333;Lendresse;80;1;81
64;148;Bruges-Capbis-Mifaget;64;384;Mifaget;120;4;124
64;440;Ozenx-Montestrucq;64;402;Montestrucq;201;6;207
64;430;Orthez;64;497;Sainte-Suzanne;1056;65;1121
64;113;Bergouey-Viellenave;64;553;Viellenave-sur-Bidouze;33;1;34
65;141;Cazaux-Fréchet-Anéran-Camors;65;008;Anéran-Camors;32;1;33
65;282;Loudenvielle;65;027;Armenteule;61;0;61
65;092;Beyrède-Jumet-Camous;65;092;Beyrède-Jumet;201;2;203
65;092;Beyrède-Jumet-Camous;65;122;Camous;25;0;25
65;192;Gavarnie-Gèdre;65;188;Gavarnie;114;2;116
65;192;Gavarnie-Gèdre;65;192;Gèdre;226;7;233
65;099;Bordères-Louron;65;227;Ilhan;9;1;10
65;054;Avezac-Prat-Lahitte;65;246;Lahitte;33;0;33
65;282;Loudenvielle;65;282;Loudenvielle;234;6;240
65;003;Adervielle-Pouchergues;65;365;Pouchergues;54;1;55
67;004;Sommerau;67;004;Allenwiller;540;13;553
67;544;Wissembourg;67;007;Altenstadt;1169;86;1255
67;418;Rountzenheim-Auenheim;67;014;Auenheim;885;14;899
67;452;Schnersheim;67;015;Avenheim;498;3;501
67;495;Truchtersheim;67;024;Behlenheim;617;16;633
67;004;Sommerau;67;041;Birkenwald;319;2;321
67;104;Drachenbronn-Birlenbach;67;042;Birlenbach;293;3;296
67;074;Cleebourg;67;064;Bremmelbach;144;1;145
67;176;Gundershoffen;67;114;Eberbach-Wœrth;179;2;181
67;153;Geiswiller-Zœbersdorf;67;153;Geiswiller;216;3;219
67;034;Berstett;67;157;Gimbrett;488;9;497
67;539;Wingersheim les Quatre Bans;67;158;Gingsheim;357;6;363
67;176;Gundershoffen;67;170;Griesbach;477;9;486
67;061;Bouxwiller;67;171;Griesbach-le-Bastberg;247;5;252
67;206;Hoffen;67;193;Hermerswiller;278;6;284
67;539;Wingersheim les Quatre Bans;67;207;Hohatzenheim;241;7;248
67;474;Soultz-sous-Forêts;67;211;Hohwiller;394;7;401
67;061;Bouxwiller;67;219;Imbsheim;533;11;544
67;442;Scharrachbergheim-Irmstett;67;224;Irmstett;324;3;327
67;452;Schnersheim;67;243;Kleinfrankenheim;470;9;479
67;339;Betschdorf;67;251;Kuhlendorf;101;1;102
67;206;Hoffen;67;262;Leiterswiller;391;6;397
67;263;Lembach;67;284;Mattstall;147;3;150
67;160;Gœrsdorf;67;294;Mitschdorf;198;4;202
67;539;Wingersheim les Quatre Bans;67;297;Mittelhausen;602;6;608
67;388;Reichshoffen;67;316;Nehwiller-près-Wœrth;393;5;398
67;351;Seebach;67;332;Niederseebach;148;3;151
67;372;Val-de-Moder;67;372;Pfaffenhoffen;2655;32;2687
67;495;Truchtersheim;67;374;Pfettisheim;943;9;952
67;435;Sarrewerden;67;376;Bischtroff-sur-Sarre;329;9;338
67;339;Betschdorf;67;390;Reimerswiller;206;2;208
67;034;Berstett;67;393;Reitwiller;595;8;603
67;061;Bouxwiller;67;399;Riedheim;175;1;176
67;372;Val-de-Moder;67;402;Ringeldorf;133;1;134
67;418;Rountzenheim-Auenheim;67;418;Rountzenheim;1068;17;1085
67;034;Berstett;67;419;Rumersheim;439;6;445
67;004;Sommerau;67;431;Salenthal;216;4;220
67;202;Hochfelden;67;439;Schaffhouse-sur-Zorn;389;7;396
67;339;Betschdorf;67;457;Schwabwiller;522;5;527
67;004;Sommerau;67;469;Singrist;455;9;464
67;495;Truchtersheim;67;495;Truchtersheim;2826;76;2902
67;372;Val-de-Moder;67;496;Uberach;1195;13;1208
67;372;Val-de-Moder;67;512;La Walck;1029;17;1046
67;530;Wickersheim-Wilshausen;67;533;Wilshausen;104;1;105
67;539;Wingersheim les Quatre Bans;67;539;Wingersheim;1139;20;1159
67;532;Willgottheim;67;549;Wœllenheim;191;3;194
67;153;Geiswiller-Zœbersdorf;67;560;Zœbersdorf;176;0;176
67;435;Sarrewerden;67;561;Zollingen;91;2;93
67;347;Obermodern-Zutzendorf;67;562;Zutzendorf;569;12;581
68;006;Bernwiller;68;006;Ammertzwiller;486;11;497
68;012;Aspach-Michelbach;68;012;Aspach-le-Haut;1442;35;1477
68;006;Bernwiller;68;031;Bernwiller;722;18;740
68;056;Brunstatt-Didenheim;68;056;Brunstatt;6371;107;6478
68;056;Brunstatt-Didenheim;68;070;Didenheim;1797;22;1819
68;240;Illtal;68;108;Grentzingen;529;11;540
68;240;Illtal;68;133;Henflingen;191;0;191
68;143;Porte du Ried;68;143;Holtzwihr;1452;51;1503
68;162;Kaysersberg Vignoble;68;162;Kaysersberg;2440;53;2493
68;162;Kaysersberg Vignoble;68;164;Kientzheim;725;12;737
68;201;Masevaux-Niederbruck;68;201;Masevaux;3276;69;3345
68;012;Aspach-Michelbach;68;206;Michelbach;325;9;334
68;219;Le Haut Soultzbach;68;219;Mortzwiller;345;13;358
68;201;Masevaux-Niederbruck;68;233;Niederbruck;406;8;414
68;240;Illtal;68;240;Oberdorf;549;7;556
68;143;Porte du Ried;68;272;Riedwihr;391;9;400
68;162;Kaysersberg Vignoble;68;310;Sigolsheim;1247;28;1275
68;219;Le Haut Soultzbach;68;314;Soppe-le-Haut;533;11;544
68;320;Spechbach;68;319;Spechbach-le-Bas;722;27;749
68;320;Spechbach;68;320;Spechbach-le-Haut;676;20;696
69;135;Deux-Grosnes;69;015;Avenas;125;7;132
69;019;Belleville-en-Beaujolais;69;019;Belleville;8373;176;8549
69;024;Val d'Oingt;69;024;Le Bois-d'Oingt;2600;60;2660
69;248;Thizy-les-Bourgs;69;025;Bourg-de-Thizy;2422;37;2459
69;248;Thizy-les-Bourgs;69;041;La Chapelle-de-Mardore;236;4;240
69;179;Beauvallon;69;048;Chassagny;1286;34;1320
69;066;Cours;69;066;Cours-la-Ville;3607;79;3686
69;157;Vindry-sur-Turdine;69;073;Dareizé;559;15;574
69;159;Porte des Pierres Dorées;69;101;Jarnioux;725;13;738
69;159;Porte des Pierres Dorées;69;114;Liergues;2206;57;2263
69;248;Thizy-les-Bourgs;69;128;Mardore;479;9;488
69;248;Thizy-les-Bourgs;69;129;Marnand;604;13;617
69;135;Deux-Grosnes;69;135;Monsols;916;17;933
69;208;Saint-Germain-Nuelles;69;144;Nuelles;688;21;709
69;024;Val d'Oingt;69;146;Oingt;677;19;696
69;157;Vindry-sur-Turdine;69;147;Les Olmes;862;16;878
69;135;Deux-Grosnes;69;150;Ouroux;335;21;356
69;157;Vindry-sur-Turdine;69;157;Pontcharra-sur-Turdine;2728;63;2791
69;066;Cours;69;158;Pont-Trambouze;423;8;431
69;159;Porte des Pierres Dorées;69;159;Pouilly-le-Monial;1020;23;1043
69;179;Beauvallon;69;179;Saint-Andéol-le-Château;1922;25;1947
69;135;Deux-Grosnes;69;185;Saint-Christophe;228;1;229
69;228;Chabanière;69;195;Saint-Didier-sous-Riverie;1262;21;1283
69;208;Saint-Germain-Nuelles;69;208;Saint-Germain-sur-l'Arbresle;1559;41;1600
69;135;Deux-Grosnes;69;210;Saint-Jacques-des-Arrêts;119;3;122
69;019;Belleville-en-Beaujolais;69;211;Saint-Jean-d'Ardières;4963;104;5067
69;179;Beauvallon;69;213;Saint-Jean-de-Touslas;866;17;883
69;024;Val d'Oingt;69;222;Saint-Laurent-d'Oingt;880;22;902
69;157;Vindry-sur-Turdine;69;223;Saint-Loup;1131;30;1161
69;135;Deux-Grosnes;69;224;Saint-Mamert;73;3;76
69;228;Chabanière;69;228;Saint-Maurice-sur-Dargoire;2396;30;2426
69;228;Chabanière;69;237;Saint-Sorlin;565;20;585
69;066;Cours;69;247;Thel;336;4;340
69;248;Thizy-les-Bourgs;69;248;Thizy;2203;54;2257
69;135;Deux-Grosnes;69;251;Trades;118;1;119
70;059;Beaumotte-Aubertans;70;033;Aubertans;120;4;124
70;101;Broye-Aubigney-Montseugny;70;034;Aubigney;102;0;102
70;373;La Roche-Morey;70;068;Betoncourt-les-Ménétriers;50;1;51
70;285;Héricourt;70;108;Bussurel;774;20;794
70;122;Champlitte;70;123;Champlitte-la-Ville;68;2;70
70;492;Soing-Cubry-Charentenay;70;131;Charentenay;108;1;109
70;477;Saulnot;70;173;Corcelles;71;1;72
70;492;Soing-Cubry-Charentenay;70;191;Cubry-lès-Soing;90;2;92
70;031;Athesans-Étroitefontaine;70;223;Étroitefontaine;26;2;28
70;447;Rioz;70;241;Les Fontenis;101;4;105
70;245;Fougerolles-Saint-Valbert;70;245;Fougerolles;3534;127;3661
70;247;Fouvent-Saint-Andoche;70;246;Fouvent-le-Bas;91;1;92
70;418;La Romaine;70;281;Greucourt;78;0;78
70;122;Champlitte;70;300;Leffond;123;1;124
70;122;Champlitte;70;333;Margilley;107;1;108
70;489;Servance-Miellin;70;345;Miellin;63;1;64
70;487;Senargent-Mignafans;70;346;Mignafans;62;0;62
70;122;Champlitte;70;354;Montarlot-lès-Champlitte;87;3;90
70;101;Broye-Aubigney-Montseugny;70;370;Montseugny;101;1;102
70;122;Champlitte;70;382;Neuvelle-lès-Champlitte;109;1;110
70;292;Jussey;70;391;Noroy-lès-Jussey;51;0;51
70;418;La Romaine;70;418;Le Pont-de-Planches;246;4;250
70;058;Beaujeu-Saint-Vallier-Pierrejux-et-Quitteur;70;434;Quitteur;104;3;107
70;247;Fouvent-Saint-Andoche;70;458;Saint-Andoche;46;1;47
70;373;La Roche-Morey;70;465;Saint-Julien;133;1;134
70;245;Fougerolles-Saint-Valbert;70;475;Saint-Valbert;250;4;254
70;489;Servance-Miellin;70;489;Servance;710;7;717
70;285;Héricourt;70;497;Tavey;510;13;523
70;418;La Romaine;70;551;Vezet;195;1;196
70;045;Avrigney-Virey;70;570;Virey;58;0;58
71;134;Navour-sur-Grosne;71;055;Brandon;322;3;325
71;134;Navour-sur-Grosne;71;134;Clermain;238;7;245
71;582;La Vineuse sur Fregande;71;180;Donzy-le-National;222;8;230
71;270;Mâcon;71;260;Loché;262;6;268
71;279;Le Rousset-Marizy;71;279;Marizy;400;14;414
71;582;La Vineuse sur Fregande;71;288;Massy;55;0;55
71;134;Navour-sur-Grosne;71;304;Montagny-sur-Grosne;97;1;98
71;279;Le Rousset-Marizy;71;375;Le Rousset;219;8;227
71;270;Mâcon;71;432;Saint-Jean-le-Priche;433;9;442
71;270;Mâcon;71;511;Sennecé-lès-Mâcon;1391;29;1420
71;582;La Vineuse sur Fregande;71;582;La Vineuse;294;9;303
71;582;La Vineuse sur Fregande;71;587;Vitry-lès-Cluny;80;2;82
72;025;Bazouges Cré sur Loir;72;025;Bazouges-sur-le-Loir;1204;28;1232
72;262;Loir en Vallée;72;063;La Chapelle-Gaugain;318;3;321
72;137;Villeneuve-en-Perseigne;72;069;Chassé;179;3;182
72;071;Montval-sur-Loir;72;071;Château-du-Loir;4376;193;4569
72;080;Cherré-Au;72;080;Cherré;1774;61;1835
72;080;Cherré-Au;72;081;Cherreau;949;19;968
72;308;Saint-Paterne - Le Chevain;72;082;Le Chevain;566;8;574
72;138;Fresnay-sur-Sarthe;72;097;Coulombiers;468;8;476
72;025;Bazouges Cré sur Loir;72;108;Cré-sur-Loir;771;19;790
72;176;Le Lude;72;117;Dissé-sous-le-Lude;529;14;543
72;128;Val-d'Étangson;72;128;Évaillé;347;5;352
72;137;Villeneuve-en-Perseigne;72;137;La Fresnaye-sur-Chédouet;934;15;949
72;262;Loir en Vallée;72;159;Lavenay;308;4;312
72;137;Villeneuve-en-Perseigne;72;162;Lignières-la-Carelle;380;8;388
72;176;Le Lude;72;176;Le Lude;3571;59;3630
72;071;Montval-sur-Loir;72;203;Montabon;714;13;727
72;137;Villeneuve-en-Perseigne;72;207;Montigny;27;1;28
72;262;Loir en Vallée;72;240;Poncé-sur-le-Loir;323;5;328
72;137;Villeneuve-en-Perseigne;72;258;Roullée;240;2;242
72;262;Loir en Vallée;72;262;Ruillé-sur-Loir;1171;118;1289
72;138;Fresnay-sur-Sarthe;72;284;Saint-Germain-sur-Sarthe;522;13;535
72;363;Tuffé Val de la Chéronne;72;288;Saint-Hilaire-le-Lierru;132;2;134
72;128;Val-d'Étangson;72;304;Sainte-Osmane;171;1;172
72;308;Saint-Paterne - Le Chevain;72;308;Saint-Paterne;1537;242;1779
72;137;Villeneuve-en-Perseigne;72;318;Saint-Rigomer-des-Bois;458;10;468
72;363;Tuffé Val de la Chéronne;72;363;Tuffé;1536;14;1550
72;071;Montval-sur-Loir;72;384;Vouvray-sur-Loir;813;11;824
73;212;Val-d'Arc;73;002;Aiguebelle;1203;9;1212
73;003;Grand-Aigueblanche;73;003;Aigueblanche;3219;88;3307
73;006;Aime-la-Plagne;73;006;Aime;2398;55;2453
73;010;Entrelacs;73;010;Albens;3926;72;3998
73;261;Saint-Michel-de-Maurienne;73;035;Beaune;52;1;53
73;150;La Plagne Tarentaise;73;038;Bellentre;921;27;948
73;003;Grand-Aigueblanche;73;045;Le Bois;409;9;418
73;187;La Léchère;73;046;Bonneval;93;1;94
73;290;Val-Cenis;73;056;Bramans;445;8;453
73;187;La Léchère;73;060;Celliers;45;0;45
73;010;Entrelacs;73;062;Cessens;464;11;475
73;135;La Tour-en-Maurienne;73;080;Le Châtel;170;3;173
73;150;La Plagne Tarentaise;73;093;La Côte-d'Aime;945;43;988
73;187;La Léchère;73;102;Doucy;377;12;389
73;010;Entrelacs;73;108;Épersy;402;16;418
73;215;Valgelon-La Rochette;73;111;Étable;432;9;441
73;187;La Léchère;73;112;Feissons-sur-Isère;563;12;575
73;284;Salins-Fontaine;73;115;Fontaine-le-Puits;121;6;127
73;151;Porte-de-Savoie;73;118;Francin;1122;19;1141
73;006;Aime-la-Plagne;73;126;Granier;342;9;351
73;236;Saint-Genix-les-Villages;73;127;Gresin;335;7;342
73;135;La Tour-en-Maurienne;73;135;Hermillon;646;10;656
73;290;Val-Cenis;73;143;Lanslebourg-Mont-Cenis;619;14;633
73;290;Val-Cenis;73;144;Lanslevillard;480;6;486
73;006;Aime-la-Plagne;73;148;Longefoy;292;8;300
73;150;La Plagne Tarentaise;73;150;Mâcot-la-Plagne;1757;57;1814
73;151;Porte-de-Savoie;73;151;Les Marches;2708;54;2762
73;010;Entrelacs;73;158;Mognard;412;13;425
73;235;Saint François Longchamp;73;163;Montaimont;137;3;140
73;235;Saint François Longchamp;73;167;Montgellafrey;88;0;88
73;006;Aime-la-Plagne;73;169;Montgirod;488;11;499
73;013;Albiez-Montrond;73;174;Montrond;36;0;36
73;187;La Léchère;73;185;Naves;121;1;122
73;187;La Léchère;73;187;Notre-Dame-de-Briançon;496;10;506
73;187;La Léchère;73;199;Petit-Cœur;566;5;571
73;135;La Tour-en-Maurienne;73;203;Pontamafrey-Montpascal;267;6;273
73;187;La Léchère;73;209;Pussy;340;9;349
73;212;Val-d'Arc;73;212;Randens;812;14;826
73;215;Valgelon-La Rochette;73;215;La Rochette;3743;60;3803
73;235;Saint François Longchamp;73;235;Saint-François-Longchamp;320;3;323
73;236;Saint-Genix-les-Villages;73;236;Saint-Genix-sur-Guiers;2347;54;2401
73;010;Entrelacs;73;238;Saint-Germain-la-Chambotte;509;13;522
73;010;Entrelacs;73;239;Saint-Girod;627;15;642
73;257;Les Belleville;73;244;Saint-Jean-de-Belleville;522;14;536
73;257;Les Belleville;73;257;Saint-Martin-de-Belleville;2631;89;2720
73;236;Saint-Genix-les-Villages;73;260;Saint-Maurice-de-Rotherens;213;6;219
73;003;Grand-Aigueblanche;73;266;Saint-Oyen;195;7;202
73;284;Salins-Fontaine;73;284;Salins-les-Thermes;873;14;887
73;290;Val-Cenis;73;287;Sollières-Sardières;171;4;175
73;290;Val-Cenis;73;290;Termignon;353;6;359
73;006;Aime-la-Plagne;73;291;Tessens;427;8;435
73;261;Saint-Michel-de-Maurienne;73;295;Thyl;35;0;35
73;150;La Plagne Tarentaise;73;305;Valezan;205;4;209
73;257;Les Belleville;73;321;Villarlurin;323;13;336
73;006;Aime-la-Plagne;73;325;Villette;486;13;499
74;010;Annecy;74;010;Annecy;54480;1314;55794
74;010;Annecy;74;011;Annecy-le-Vieux;22713;547;23260
74;282;Fillière;74;022;Aviernoz;896;30;926
74;167;Val de Chaise;74;084;Cons-Sainte-Colombe;394;10;404
74;010;Annecy;74;093;Cran-Gevrier;18671;450;19121
74;220;Reignier-Ésery;74;113;Ésery;614;8;622
74;282;Fillière;74;120;Évires;1486;37;1523
74;167;Val de Chaise;74;167;Marlens;993;14;1007
74;010;Annecy;74;182;Meythet;8253;199;8452
74;275;Talloires-Montmin;74;187;Montmin;322;3;325
74;282;Fillière;74;204;Les Ollières;1069;19;1088
74;010;Annecy;74;217;Pringy;4608;111;4719
74;282;Fillière;74;245;Saint-Martin-Bellevue;2792;81;2873
74;010;Annecy;74;268;Seynod;23041;555;23596
74;275;Talloires-Montmin;74;275;Talloires;1602;63;1665
74;282;Fillière;74;282;Thorens-Glières;3291;80;3371
76;020;Anneville-Ambourville;76;003;Ambourville;187;3;190
76;618;Petit-Caux;76;027;Assigny;385;5;390
76;476;Port-Jérôme-sur-Seine;76;031;Auberville-la-Campagne;649;12;661
76;034;Val-de-Scie;76;034;Auffay;1837;17;1854
76;618;Petit-Caux;76;037;Auquemesnil;262;3;265
76;041;Les Hauts-de-Caux;76;041;Autretot;664;10;674
76;258;Terres-de-Caux;76;044;Auzouville-Auberbosc;304;6;310
76;618;Petit-Caux;76;073;Belleville-sur-Mer;1032;24;1056
76;258;Terres-de-Caux;76;078;Bennetot;183;2;185
76;258;Terres-de-Caux;76;080;Bermonville;494;15;509
76;618;Petit-Caux;76;081;Berneval-le-Grand;1425;29;1454
76;618;Petit-Caux;76;098;Biville-sur-Mer;850;17;867
76;146;Buchy;76;127;Bosc-Roger-sur-Buchy;722;17;739
76;618;Petit-Caux;76;137;Bracquemont;864;32;896
76;618;Petit-Caux;76;145;Brunville;248;2;250
76;146;Buchy;76;146;Buchy;1593;88;1681
76;164;Rives-en-Seine;76;164;Caudebec-en-Caux;2242;35;2277
76;034;Val-de-Scie;76;191;Cressy;293;3;296
76;618;Petit-Caux;76;215;Derchigny;591;12;603
76;146;Buchy;76;248;Estouteville-Écalles;505;8;513
76;258;Terres-de-Caux;76;258;Fauville-en-Caux;2326;74;2400
76;276;Forges-les-Eaux;76;276;Forges-les-Eaux;3244;165;3409
76;276;Forges-les-Eaux;76;277;Le Fossé;506;7;513
76;618;Petit-Caux;76;301;Glicourt;271;2;273
76;618;Petit-Caux;76;310;Gouchaupre;196;2;198
76;618;Petit-Caux;76;326;Greny;123;2;125
76;618;Petit-Caux;76;337;Guilmécourt;417;7;424
76;618;Petit-Caux;76;376;Intraville;315;6;321
76;401;Arelaune-en-Seine;76;401;La Mailleraye-sur-Seine;1922;31;1953
76;217;Dieppe;76;466;Neuville-lès-Dieppe;9280;147;9427
76;476;Port-Jérôme-sur-Seine;76;476;Notre-Dame-de-Gravenchon;8836;158;8994
76;618;Petit-Caux;76;496;Penly;495;6;501
76;258;Terres-de-Caux;76;525;Ricarville;310;4;314
76;351;Le Havre;76;539;Rouelles;2994;33;3027
76;258;Terres-de-Caux;76;607;Sainte-Marguerite-sur-Fauville;281;4;285
76;618;Petit-Caux;76;618;Saint-Martin-en-Campagne;1243;45;1288
76;401;Arelaune-en-Seine;76;625;Saint-Nicolas-de-Bliquetuit;602;13;615
76;258;Terres-de-Caux;76;639;Saint-Pierre-Lavis;307;7;314
76;618;Petit-Caux;76;643;Saint-Quentin-au-Bosc;108;0;108
76;164;Rives-en-Seine;76;659;Saint-Wandrille-Rançon;1176;20;1196
76;034;Val-de-Scie;76;674;Sévis;395;5;400
76;618;Petit-Caux;76;696;Tocqueville-sur-Eu;217;4;221
76;476;Port-Jérôme-sur-Seine;76;701;Touffreville-la-Cable;420;9;429
76;618;Petit-Caux;76;704;Tourville-la-Chapelle;612;10;622
76;476;Port-Jérôme-sur-Seine;76;713;Triquerville;359;10;369
76;041;Les Hauts-de-Caux;76;729;Veauville-lès-Baons;683;8;691
76;164;Rives-en-Seine;76;742;Villequier;674;11;685
77;316;Moret-Loing-et-Orvanne;77;166;Écuelles;2399;65;2464
77;316;Moret-Loing-et-Orvanne;77;170;Épisy;635;17;652
77;262;Louan-Villegruis-Fontaine;77;189;Fontaine-sous-Montaiguillon;95;5;100
77;316;Moret-Loing-et-Orvanne;77;299;Montarlot;242;7;249
77;316;Moret-Loing-et-Orvanne;77;316;Moret-sur-Loing;4257;115;4372
77;093;La Chapelle-Moutils;77;324;Moutils;123;1;124
77;264;Lumigny-Nesles-Ormeaux;77;334;Nesles;581;13;594
77;264;Lumigny-Nesles-Ormeaux;77;346;Ormeaux;367;3;370
77;010;Aubepierre-Ozouer-le-Repos;77;351;Ozouer-le-Repos;385;3;388
77;261;Lorrez-le-Bocage-Préaux;77;375;Préaux;116;1;117
77;504;Villemaréchal;77;399;Saint-Ange-le-Viel;234;3;237
77;316;Moret-Loing-et-Orvanne;77;491;Veneux-les-Sablons;4974;134;5108
77;421;Saint-Mars-Vieux-Maisons;77;497;Vieux-Maisons;92;2;94
77;031;Bernay-Vilbert;77;499;Vilbert;354;2;356
77;020;Bannost-Villegagnon;77;502;Villegagnon;198;3;201
77;504;Villemaréchal;77;504;Villemaréchal;862;20;882
78;158;Le Chesnay-Rocquencourt;78;158;Le Chesnay;27363;573;27936
78;551;Saint-Germain-en-Laye;78;251;Fourqueux;3822;152;3974
78;158;Le Chesnay-Rocquencourt;78;524;Rocquencourt;3694;77;3771
79;185;Aigondigné;79;004;Aigonnay;632;22;654
79;005;Airvault;79;005;Airvault;2189;31;2220
79;136;Alloinay;79;006;Les Alleuds;294;5;299
79;013;Argentonnay;79;013;Argenton-les-Vallées;1631;59;1690
79;014;Loretz-d'Argenton;79;014;Argenton-l'Église;1373;25;1398
79;014;Loretz-d'Argenton;79;026;Bagneux;224;3;227
79;083;Chef-Boutonne;79;027;La Bataille;72;0;72
79;049;Bressuire;79;028;Beaulieu-sous-Bressuire;909;45;954
79;078;Plaine-d'Argenson;79;033;Belleville;152;1;153
79;077;Beugnon-Thireuil;79;035;Le Beugnon;284;3;287
79;078;Plaine-d'Argenson;79;039;Boisserolles;56;3;59
79;005;Airvault;79;041;Borcq-sur-Airvault;239;4;243
79;014;Loretz-d'Argenton;79;043;Bouillé-Loretz;1012;20;1032
79;063;Val en Vignes;79;044;Bouillé-Saint-Paul;380;87;467
79;179;Moncoutant-sur-Sèvre;79;051;Le Breuil-Bernard;542;14;556
79;049;Bressuire;79;052;Breuil-Chaussée;1059;52;1111
79;013;Argentonnay;79;053;Le Breuil-sous-Argenton;434;5;439
79;196;Plaine-et-Vallées;79;054;Brie;173;2;175
79;061;Celles-sur-Belle;79;061;Celles-sur-Belle;2456;50;2506
79;063;Val en Vignes;79;063;Cersay;771;16;787
79;064;Fontivillié;79;064;Chail;502;12;514
79;049;Bressuire;79;065;Chambroutet;508;25;533
79;105;Les Châteliers;79;068;Chantecorps;316;9;325
79;013;Argentonnay;79;072;La Chapelle-Gaudin;240;2;242
79;079;Mauléon;79;073;La Chapelle-Largeau;1048;17;1065
79;179;Moncoutant-sur-Sèvre;79;075;La Chapelle-Saint-Étienne;331;5;336
79;077;Beugnon-Thireuil;79;077;La Chapelle-Thireuil;449;7;456
79;083;Chef-Boutonne;79;083;Chef-Boutonne;1973;100;2073
79;049;Bressuire;79;093;Clazay;674;33;707
79;217;Prailles-La Couarde;79;098;La Couarde;275;3;278
79;013;Argentonnay;79;099;La Coudre;214;5;219
79;105;Les Châteliers;79;105;Coutières;149;4;153
79;083;Chef-Boutonne;79;107;Crézières;38;0;38
79;280;Saint Maurice Étusson;79;113;Étusson;336;6;342
79;016;Assais-les-Jumeaux;79;143;Les Jumeaux;283;3;286
79;079;Mauléon;79;155;Loublande;929;22;951
79;063;Val en Vignes;79;168;Massais;606;11;617
79;329;Thouars;79;171;Mauzé-Thouarsais;2147;48;2195
79;174;Melle;79;173;Mazières-sur-Béronne;399;12;411
79;174;Melle;79;174;Melle;3294;234;3528
79;329;Thouars;79;178;Missé;837;19;856
79;179;Moncoutant-sur-Sèvre;79;179;Moncoutant;3155;140;3295
79;061;Celles-sur-Belle;79;181;Montigné;288;1;289
79;123;La Forêt-sur-Sèvre;79;182;Montigny;596;10;606
79;185;Aigondigné;79;185;Mougon;2119;71;2190
79;079;Mauléon;79;186;Moulins;700;14;714
79;013;Argentonnay;79;187;Moutiers-sous-Argenton;624;14;638
79;179;Moncoutant-sur-Sèvre;79;188;Moutiers-sous-Chantemerle;598;12;610
79;049;Bressuire;79;192;Noirlieu;351;17;368
79;049;Bressuire;79;193;Noirterre;1002;50;1052
79;196;Plaine-et-Vallées;79;196;Oiron;912;18;930
79;174;Melle;79;199;Paizay-le-Tort;506;9;515
79;217;Prailles-La Couarde;79;217;Prailles;676;19;695
79;334;Val-du-Mignon;79;219;Priaires;116;0;116
79;179;Moncoutant-sur-Sèvre;79;222;Pugny;235;6;241
49;099;Cholet;79;224;Le Puy-Saint-Bonnet;2223;79;2302
79;123;La Forêt-sur-Sèvre;79;232;La Ronde;423;13;436
79;079;Mauléon;79;233;Rorthais;774;12;786
79;079;Mauléon;79;237;Saint-Aubin-de-Baubigné;1431;31;1462
79;185;Aigondigné;79;240;Sainte-Blandine;686;18;704
79;078;Plaine-d'Argenson;79;247;Saint-Étienne-la-Cigogne;158;3;161
79;196;Plaine-et-Vallées;79;260;Saint-Jouin-de-Marnes;539;12;551
79;179;Moncoutant-sur-Sèvre;79;261;Saint-Jouin-de-Milly;209;4;213
79;174;Melle;79;264;Saint-Léger-de-la-Martinière;998;30;1028
79;123;La Forêt-sur-Sèvre;79;272;Saint-Marsault;509;11;520
79;174;Melle;79;279;Saint-Martin-lès-Melle;821;16;837
79;280;Saint Maurice Étusson;79;280;Saint-Maurice-la-Fougereuse;545;9;554
79;061;Celles-sur-Belle;79;282;Saint-Médard;112;2;114
79;285;Saint-Pardoux-Soutiers;79;285;Saint-Pardoux;1592;36;1628
79;063;Val en Vignes;79;288;Saint-Pierre-à-Champ;278;5;283
79;329;Thouars;79;292;Sainte-Radegonde;1799;40;1839
79;049;Bressuire;79;296;Saint-Sauveur;1599;79;1678
79;064;Fontivillié;79;314;Sompt;321;7;328
79;005;Airvault;79;317;Soulièvres;525;11;536
79;285;Saint-Pardoux-Soutiers;79;318;Soutiers;263;5;268
79;196;Plaine-et-Vallées;79;321;Taizé-Maulais;743;17;760
79;079;Mauléon;79;323;Le Temple;488;6;494
79;049;Bressuire;79;324;Terves;2586;128;2714
79;005;Airvault;79;325;Tessonnière;326;3;329
79;185;Aigondigné;79;327;Thorigné;1246;38;1284
79;334;Val-du-Mignon;79;328;Thorigny-sur-le-Mignon;89;1;90
79;083;Chef-Boutonne;79;330;Tillou;324;7;331
79;013;Argentonnay;79;333;Ulcot;54;1;55
79;334;Val-du-Mignon;79;334;Usseau;872;20;892
79;061;Celles-sur-Belle;79;344;Verrines-sous-Celles;1025;26;1051
80;436;Hescamps;80;007;Agnières;150;3;153
80;443;Hornoy-le-Bourg;80;111;Boisrault;112;0;112
80;505;Carnoy-Mametz;80;175;Carnoy;108;0;108
80;554;Molliens-Dreuil;80;257;Dreuil-lès-Molliens;146;1;147
80;557;Estrées-Mons;80;289;Estrées-en-Chaussée;75;3;78
80;295;Étinehem-Méricourt;80;295;Étinehem;383;4;387
80;436;Hescamps;80;363;Frettemolle;108;4;112
80;443;Hornoy-le-Bourg;80;382;Gouy-l'Hôpital;43;1;44
80;703;Saint-Germain-sur-Bresle;80;394;Guémicourt;18;1;19
80;456;Lafresguimont-Saint-Martin;80;398;Guibermesnil;59;1;60
80;406;Hallencourt;80;441;Hocquincourt;111;2;113
80;621;Hypercourt;80;447;Hyencourt-le-Grand;76;1;77
80;456;Lafresguimont-Saint-Martin;80;454;Laboissière-Saint-Martin;60;0;60
80;630;Poix-de-Picardie;80;457;Lahaye-Saint-Romain;276;2;278
80;443;Hornoy-le-Bourg;80;483;Lincheux-Hallivillers;156;5;161
80;485;Ô-de-Selle;80;485;Lœuilly;797;8;805
80;245;Domléger-Longvillers;80;492;Longvillers;168;1;169
80;505;Carnoy-Mametz;80;505;Mametz;185;4;189
80;509;Marchélepot-Misery;80;509;Marchélepot;456;6;462
80;222;Crécy-en-Ponthieu;80;510;Marcheville;113;3;116
80;295;Étinehem-Méricourt;80;532;Méricourt-sur-Somme;210;6;216
80;509;Marchélepot-Misery;80;551;Misery;136;0;136
80;456;Lafresguimont-Saint-Martin;80;564;Montmarquet;213;4;217
80;582;Namps-Maisnil;80;581;Namps-au-Mont;191;1;192
80;485;Ô-de-Selle;80;594;Neuville-lès-Lœuilly;129;2;131
80;621;Hypercourt;80;608;Omiécourt;265;1;266
80;623;Piennes-Onvillers;80;610;Onvillers;114;1;115
80;443;Hornoy-le-Bourg;80;612;Orival;223;3;226
80;621;Hypercourt;80;621;Pertain;374;9;383
80;582;Namps-Maisnil;80;689;Rumaisnil;114;1;115
80;229;Crouy-Saint-Pierre;80;712;Saint-Pierre-à-Gouy;72;1;73
80;443;Hornoy-le-Bourg;80;731;Selincourt;97;0;97
80;436;Hescamps;80;739;Souplicourt;85;0;85
80;582;Namps-Maisnil;80;745;Taisnil;320;2;322
80;485;Ô-de-Selle;80;761;Tilloy-lès-Conty;242;0;242
80;443;Hornoy-le-Bourg;80;768;Tronchoy;224;4;228
80;211;Conty;80;816;Wailly;166;0;166
80;406;Hallencourt;80;817;Wanel;140;0;140
81;262;Saint-Marcel-Campes;81;057;Campes;100;0;100
81;218;Puygouzon;81;113;Labastide-Dénat;425;7;432
81;233;Terre-de-Bancalié;81;226;Ronel;334;4;338
81;233;Terre-de-Bancalié;81;233;Roumégoux;269;4;273
81;233;Terre-de-Bancalié;81;241;Saint-Antonin-de-Lacalm;285;3;288
81;233;Terre-de-Bancalié;81;260;Saint-Lieux-Lafenasse;456;9;465
81;233;Terre-de-Bancalié;81;296;Terre-Clapier;265;6;271
81;233;Terre-de-Bancalié;81;301;Le Travet;121;2;123
85;001;L'Aiguillon-la-Presqu'île;85;001;L'Aiguillon-sur-Mer;2052;32;2084
85;008;Aubigny-Les Clouzeaux;85;008;Aubigny;4069;60;4129
85;009;Auchay-sur-Vendée;85;009;Auzay;661;14;675
85;019;Bellevigny;85;019;Belleville-sur-Vie;4075;94;4169
85;146;Montaigu-Vendée;85;027;Boufféré;3476;106;3582
85;084;Essarts en Bocage;85;030;Boulogne;997;12;1009
85;213;Rives de l'Yon;85;043;Chaillé-sous-les-Ormeaux;1366;25;1391
85;009;Auchay-sur-Vendée;85;044;Chaix;488;7;495
85;302;Chanverrie;85;048;Chambretaud;1563;37;1600
85;152;Les Achards;85;052;La Chapelle-Achard;2108;27;2135
85;090;Sèvremont;85;063;Les Châtelliers-Châteaumur;776;8;784
85;036;La Bretonnière-la-Claye;85;068;La Claye;105;4;109
85;008;Aubigny-Les Clouzeaux;85;069;Les Clouzeaux;2971;46;3017
85;135;Mareuil-sur-Lay-Dissais;85;079;Dissais;403;12;415
85;080;Doix lès Fontaines;85;080;Doix;975;18;993
85;084;Essarts en Bocage;85;084;Les Essarts;5738;104;5842
85;090;Sèvremont;85;090;La Flocellière;2606;46;2652
85;080;Doix lès Fontaines;85;091;Fontaines;765;15;780
85;146;Montaigu-Vendée;85;107;La Guyonnière;2760;84;2844
85;020;Benet;85;122;Lesson;624;15;639
85;146;Montaigu-Vendée;85;146;Montaigu;5178;158;5336
85;197;Montréverd;85;150;Mormaison;1224;11;1235
85;152;Les Achards;85;152;La Mothe-Achard;3223;87;3310
85;154;Mouilleron-Saint-Germain;85;154;Mouilleron-en-Pareds;1358;78;1436
85;162;Rives-d'Autise;85;162;Nieul-sur-l'Autise;1278;41;1319
85;084;Essarts en Bocage;85;165;L'Oie;1246;28;1274
85;162;Rives-d'Autise;85;168;Oulmes;804;20;824
85;177;Les Velluire-sur-Vendée;85;177;Le Poiré-sur-Velluire;664;12;676
85;090;Sèvremont;85;180;La Pommeraie-sur-Sèvre;986;26;1012
85;197;Montréverd;85;197;Saint-André-Treize-Voies;1448;28;1476
85;020;Benet;85;203;Sainte-Christine;358;5;363
85;084;Essarts en Bocage;85;212;Sainte-Florence;1319;20;1339
85;213;Rives de l'Yon;85;213;Saint-Florent-des-Bois;2872;147;3019
85;146;Montaigu-Vendée;85;217;Saint-Georges-de-Montaigu;4346;133;4479
85;154;Mouilleron-Saint-Germain;85;219;Saint-Germain-l'Aiguiller;428;12;440
85;146;Montaigu-Vendée;85;224;Saint-Hilaire-de-Loulay;4818;147;4965
85;040;La Caillère-Saint-Hilaire;85;230;Saint-Hilaire-du-Bois;303;5;308
85;090;Sèvremont;85;257;Saint-Michel-Mont-Mercure;2049;175;2224
85;051;Chantonnay;85;263;Saint-Philbert-du-Pont-Charrault;1041;10;1051
85;277;Saint-Vincent-sur-Graon;85;270;Saint-Sornin;104;3;107
85;197;Montréverd;85;272;Saint-Sulpice-le-Verdon;1118;21;1139
85;034;Bournezeau;85;275;Saint-Vincent-Puymaufrais;554;6;560
85;019;Bellevigny;85;279;Saligny;2118;33;2151
85;177;Les Velluire-sur-Vendée;85;299;Velluire;713;19;732
85;302;Chanverrie;85;302;La Verrie;3905;98;4003
85;001;L'Aiguillon-la-Presqu'île;85;307;La Faute-sur-Mer;693;12;705
86;019;Beaumont Saint-Cyr;86;019;Beaumont;1835;26;1861
86;123;Boivre-la-Vallée;86;021;Benassay;867;10;877
86;281;Saint-Martin-la-Pallu;86;030;Blaslay;532;5;537
86;082;Valence-en-Poitou;86;043;Ceaux-en-Couhé;538;11;549
86;123;Boivre-la-Vallée;86;056;La Chapelle-Montreuil;729;14;743
86;281;Saint-Martin-la-Pallu;86;060;Charrais;1098;27;1125
86;082;Valence-en-Poitou;86;067;Châtillon;225;6;231
86;281;Saint-Martin-la-Pallu;86;071;Cheneché;381;3;384
86;082;Valence-en-Poitou;86;082;Couhé;1802;42;1844
86;225;Saint-Jean-de-Sauves;86;101;Frontenay-sur-Dive;189;5;194
86;115;Jaunay-Marigny;86;115;Jaunay-Clan;6345;234;6579
86;123;Boivre-la-Vallée;86;123;Lavausseau;732;16;748
86;115;Jaunay-Marigny;86;146;Marigny-Brizay;1319;21;1340
86;161;Moncontour;86;155;Messais;100;3;103
86;123;Boivre-la-Vallée;86;166;Montreuil-Bonnin;751;12;763
86;108;La Grimaudière;86;179;Notre-Dame-d'Or;91;1;92
86;161;Moncontour;86;185;Ouzilly-Vignolles;194;2;196
86;082;Valence-en-Poitou;86;188;Payré;1047;54;1101
86;070;Chauvigny;86;199;Pouzioux;245;3;248
86;137;Loudun;86;212;Rossay;263;6;269
86;161;Moncontour;86;216;Saint-Chartres;102;2;104
86;019;Beaumont Saint-Cyr;86;219;Saint-Cyr;1119;14;1133
86;245;Senillé-Saint-Sauveur;86;245;Saint-Sauveur;998;21;1019
86;245;Senillé-Saint-Sauveur;86;259;Senillé;756;20;776
86;066;Châtellerault;86;267;Targé;933;23;956
86;281;Saint-Martin-la-Pallu;86;277;Varennes;351;5;356
86;082;Valence-en-Poitou;86;278;Vaux;800;16;816
86;281;Saint-Martin-la-Pallu;86;281;Vendeuvre-du-Poitou;3232;46;3278
86;108;La Grimaudière;86;283;Verger-sur-Dive;99;5;104
87;097;Val d'Issoire;87;026;Bussière-Boffy;278;3;281
87;028;Val-d'Oire-et-Gartempe;87;028;Bussière-Poitevine;841;5;846
87;028;Val-d'Oire-et-Gartempe;87;055;Darnac;344;5;349
87;097;Val d'Issoire;87;097;Mézières-sur-Issoire;735;9;744
87;092;Marval;87;098;Milhaguet;102;3;105
87;128;Saint-Pardoux-le-Lac;87;128;Roussac;466;4;470
87;028;Val-d'Oire-et-Gartempe;87;136;Saint-Barbant;325;8;333
87;027;Bussière-Galant;87;171;Saint-Nicolas-Courbefy;145;4;149
87;128;Saint-Pardoux-le-Lac;87;173;Saint-Pardoux;617;9;626
87;180;Saint-Sornin-Leulac;87;175;Saint-Priest-le-Betoux;59;0;59
87;128;Saint-Pardoux-le-Lac;87;184;Saint-Symphorien-sur-Couze;247;2;249
87;028;Val-d'Oire-et-Gartempe;87;196;Thiat;159;3;162
88;218;Granges-Aumontzey;88;018;Aumontzey;475;7;482
88;029;La Vôge-les-Bains;88;029;Bains-les-Bains;1132;115;1247
88;322;La Neuveville-devant-Lépanges;88;067;Le Boulay;223;6;229
88;361;Provenchères-et-Colroy;88;112;Colroy-la-Grande;506;97;603
88;465;Thaon-les-Vosges;88;204;Girmont;978;17;995
88;218;Granges-Aumontzey;88;218;Granges-sur-Vologne;2130;49;2179
88;029;La Vôge-les-Bains;88;234;Harsault;325;5;330
88;029;La Vôge-les-Bains;88;235;Hautmougey;132;3;135
88;465;Thaon-les-Vosges;88;337;Oncourt;190;7;197
88;361;Provenchères-et-Colroy;88;361;Provenchères-sur-Fave;822;18;840
88;322;La Neuveville-devant-Lépanges;88;420;Saint-Jean-du-Marché;92;1;93
88;465;Thaon-les-Vosges;88;465;Thaon-les-Vosges;7415;192;7607
89;130;Deux Rivières;89;001;Accolay;448;5;453
89;003;Montholon;89;003;Aillant-sur-Tholon;1671;47;1718
89;055;Brienon-sur-Armançon;89;047;Bligny-en-Othe;92;6;98
89;439;Vergigny;89;052;Bouilly;199;3;202
89;086;Charny Orée de Puisaye;89;070;Chambeugle;48;2;50
89;003;Montholon;89;078;Champvallon;366;16;382
89;086;Charny Orée de Puisaye;89;086;Charny;1451;18;1469
89;283;Ouanne;89;090;Chastenay;111;3;114
89;086;Charny Orée de Puisaye;89;097;Chêne-Arnoult;106;1;107
89;086;Charny Orée de Puisaye;89;103;Chevillon;313;14;327
89;411;Les Vallées de la Vanne;89;107;Chigy;341;5;346
89;197;Guillon-Terre-Plaine;89;109;Cisery;55;0;55
89;407;Tanlay;89;114;Commissey;188;9;197
89;130;Deux Rivières;89;130;Cravant;817;25;842
89;086;Charny Orée de Puisaye;89;138;Dicy;304;7;311
89;014;Arces-Dilo;89;140;Dilo;64;3;67
89;233;Lucy-sur-Cure;89;157;Essert;65;1;66
89;414;Thorigny-sur-Oreuse;89;166;Fleurigny;361;11;372
89;405;Les Hauts de Forterre;89;174;Fontenailles;66;1;67
89;086;Charny Orée de Puisaye;89;178;Fontenouilles;213;4;217
89;086;Charny Orée de Puisaye;89;192;Grandchamp;341;9;350
89;196;Valravillon;89;196;Guerchy;751;20;771
89;197;Guillon-Terre-Plaine;89;197;Guillon;434;10;444
89;196;Valravillon;89;213;Laduz;291;12;303
89;073;Champignelles;89;231;Louesme;58;1;59
89;086;Charny Orée de Puisaye;89;241;Malicorne;148;3;151
89;086;Charny Orée de Puisaye;89;243;Marchais-Beton;122;2;124
89;405;Les Hauts de Forterre;89;260;Molesmes;172;4;176
89;196;Valravillon;89;275;Neuilly;440;12;452
89;420;Treigny-Perreuse-Sainte-Colombe;89;293;Perreuse;63;1;64
89;086;Charny Orée de Puisaye;89;294;Perreux;330;3;333
89;086;Charny Orée de Puisaye;89;317;Prunoy;277;2;279
89;439;Vergigny;89;322;Rebourseaux;295;5;300
89;441;Vermenton;89;330;Sacy;167;1;168
89;334;Le Val d'Ocre;89;334;Saint-Aubin-Château-Neuf;503;6;509
89;420;Treigny-Perreuse-Sainte-Colombe;89;340;Sainte-Colombe-sur-Loing;218;2;220
89;086;Charny Orée de Puisaye;89;343;Saint-Denis-sur-Ouanne;142;1;143
89;334;Le Val d'Ocre;89;356;Saint-Martin-sur-Ocre;52;1;53
89;414;Thorigny-sur-Oreuse;89;357;Saint-Martin-sur-Oreuse;388;9;397
89;086;Charny Orée de Puisaye;89;358;Saint-Martin-sur-Ouanne;376;2;378
89;407;Tanlay;89;372;Saint-Vinnemer;229;4;233
89;197;Guillon-Terre-Plaine;89;381;Sceaux;116;2;118
89;344;Saint-Fargeau;89;389;Septfonds;137;0;137
89;263;Monéteau;89;401;Sougères-sur-Sinotte;500;11;511
89;405;Les Hauts de Forterre;89;405;Taingy;261;4;265
89;411;Les Vallées de la Vanne;89;411;Theil-sur-Vanne;449;8;457
89;420;Treigny-Perreuse-Sainte-Colombe;89;420;Treigny;726;18;744
89;197;Guillon-Terre-Plaine;89;421;Trévilly;58;1;59
89;411;Les Vallées de la Vanne;89;429;Vareilles;230;5;235
89;024;Auxerre;89;435;Vaux;411;13;424
89;197;Guillon-Terre-Plaine;89;448;Vignes;73;2;75
89;086;Charny Orée de Puisaye;89;454;Villefranche;588;9;597
89;196;Valravillon;89;457;Villemer;270;7;277
89;003;Montholon;89;473;Villiers-sur-Tholon;470;13;483
89;472;Villiers-Saint-Benoît;89;476;La Villotte;83;0;83
89;003;Montholon;89;484;Volgré;307;11;318
91;390;Le Mérévillois;91;222;Estouches;254;4;258
91;390;Le Mérévillois;91;390;Méréville;3053;39;3092
